统计序号,client发送时间(ms),client接收时间(ms),server发送时间(ms),server接收时间(ms),本地总线间隔时间(ms),占比百分比(%),服务端间隔时间(ms),占比百分比(%),对比百分比1 L/S(%),对比百分比2 S/L(%),,单程1,单程2
0,14380047,14380140,14380094,14380109,78,83.870968,15,16.129032,520,19.230769,,47,31
1,14380140,14380187,14380172,14380187,32,68.085106,15,31.914894,213.333333,46.875,,32,0
2,14380187,14380296,14380234,14380265,78,71.559633,31,28.440367,251.612903,39.74359,,47,31
3,14380296,14380343,14380312,14380343,16,34.042553,31,65.957447,51.612903,193.75,,16,0
4,14380343,14380437,14380390,14380406,78,82.978723,16,17.021277,487.5,20.512821,,47,31
5,14380437,14380499,14380452,14380484,30,48.387097,32,51.612903,93.75,106.666667,,15,15
6,14380499,14380593,14380530,14380562,62,65.957447,32,34.042553,193.75,51.612903,,31,31
7,14380593,14380640,14380608,14380640,15,31.914894,32,68.085106,46.875,213.333333,,15,0
8,14380640,14380749,14380686,14380702,93,85.321101,16,14.678899,581.25,17.204301,,46,47
9,14380749,14380796,14380749,14380780,16,34.042553,31,65.957447,51.612903,193.75,,0,16
10,14380796,14380889,14380827,14380858,62,66.666667,31,33.333333,200,50,,31,31
11,14380889,14380936,14380905,14380920,32,68.085106,15,31.914894,213.333333,46.875,,16,16
12,14380936,14381045,14380983,14380998,94,86.238532,15,13.761468,626.666667,15.957447,,47,47
13,14381045,14381092,14381061,14381076,32,68.085106,15,31.914894,213.333333,46.875,,16,16
14,14381092,14381186,14381123,14381154,63,67.021277,31,32.978723,203.225806,49.206349,,31,32
15,14381186,14381248,14381201,14381217,46,74.193548,16,25.806452,287.5,34.782609,,15,31
16,14381248,14381342,14381279,14381295,78,82.978723,16,17.021277,487.5,20.512821,,31,47
17,14381342,14381388,14381342,14381373,15,32.608696,31,67.391304,48.387097,206.666667,,0,15
18,14381388,14381435,14381420,14381435,32,68.085106,15,31.914894,213.333333,46.875,,32,0
19,14381435,14381544,14381498,14381513,94,86.238532,15,13.761468,626.666667,15.957447,,63,31
20,14381544,14381591,14381560,14381591,16,34.042553,31,65.957447,51.612903,193.75,,16,0
21,14381591,14381685,14381638,14381654,78,82.978723,16,17.021277,487.5,20.512821,,47,31
22,14381685,14381747,14381716,14381732,46,74.193548,16,25.806452,287.5,34.782609,,31,15
23,14381747,14381841,14381778,14381810,62,65.957447,32,34.042553,193.75,51.612903,,31,31
24,14381841,14381888,14381856,14381888,15,31.914894,32,68.085106,46.875,213.333333,,15,0
25,14381888,14381997,14381934,14381950,93,85.321101,16,14.678899,581.25,17.204301,,46,47
26,14381997,14382044,14381997,14382028,16,34.042553,31,65.957447,51.612903,193.75,,0,16
27,14382044,14382137,14382075,14382106,62,66.666667,31,33.333333,200,50,,31,31
28,14382137,14382200,14382153,14382168,48,76.190476,15,23.809524,320,31.25,,16,32
29,14382200,14382293,14382231,14382246,78,83.870968,15,16.129032,520,19.230769,,31,47
30,14382293,14382340,14382293,14382324,16,34.042553,31,65.957447,51.612903,193.75,,0,16
31,14382340,14382449,14382371,14382402,78,71.559633,31,28.440367,251.612903,39.74359,,31,47
32,14382449,14382496,14382449,14382465,31,65.957447,16,34.042553,193.75,51.612903,,0,31
33,14382496,14382590,14382512,14382543,63,67.021277,31,32.978723,203.225806,49.206349,,16,47
34,14382590,14382636,14382605,14382621,30,65.217391,16,34.782609,187.5,53.333333,,15,15
35,14382636,14382746,14382668,14382699,79,71.818182,31,28.181818,254.83871,39.240506,,32,47
36,14382746,14382792,14382746,14382761,31,67.391304,15,32.608696,206.666667,48.387097,,0,31
37,14382792,14382839,14382824,14382839,32,68.085106,15,31.914894,213.333333,46.875,,32,0
38,14382839,14382948,14382886,14382917,78,71.559633,31,28.440367,251.612903,39.74359,,47,31
39,14382948,14382995,14382964,14382980,31,65.957447,16,34.042553,193.75,51.612903,,16,15
40,14382995,14383089,14383042,14383058,78,82.978723,16,17.021277,487.5,20.512821,,47,31
41,14383089,14383136,14383104,14383136,15,31.914894,32,68.085106,46.875,213.333333,,15,0
42,14383136,14383245,14383182,14383198,93,85.321101,16,14.678899,581.25,17.204301,,46,47
43,14383245,14383292,14383260,14383276,31,65.957447,16,34.042553,193.75,51.612903,,15,16
44,14383292,14383385,14383323,14383354,62,66.666667,31,33.333333,200,50,,31,31
45,14383385,14383448,14383401,14383416,48,76.190476,15,23.809524,320,31.25,,16,32
46,14383448,14383541,14383479,14383494,78,83.870968,15,16.129032,520,19.230769,,31,47
47,14383541,14383588,14383541,14383572,16,34.042553,31,65.957447,51.612903,193.75,,0,16
48,14383588,14383697,14383619,14383635,93,85.321101,16,14.678899,581.25,17.204301,,31,62
49,14383697,14383791,14383744,14383760,78,82.978723,16,17.021277,487.5,20.512821,,47,31
50,14383791,14383838,14383822,14383838,31,65.957447,16,34.042553,193.75,51.612903,,31,0
51,14383838,14383947,14383884,14383916,77,70.642202,32,29.357798,240.625,41.558442,,46,31
52,14383947,14383994,14383962,14383978,31,65.957447,16,34.042553,193.75,51.612903,,15,16
53,14383994,14384087,14384040,14384056,77,82.795699,16,17.204301,481.25,20.779221,,46,31
54,14384087,14384150,14384103,14384134,32,50.793651,31,49.206349,103.225806,96.875,,16,16
55,14384150,14384243,14384181,14384196,78,83.870968,15,16.129032,520,19.230769,,31,47
56,14384243,14384290,14384243,14384274,16,34.042553,31,65.957447,51.612903,193.75,,0,16
57,14384290,14384399,14384321,14384352,78,71.559633,31,28.440367,251.612903,39.74359,,31,47
58,14384399,14384446,14384399,14384415,31,65.957447,16,34.042553,193.75,51.612903,,0,31
59,14384446,14384540,14384477,14384493,78,82.978723,16,17.021277,487.5,20.512821,,31,47
60,14384540,14384649,14384586,14384618,77,70.642202,32,29.357798,240.625,41.558442,,46,31
61,14384649,14384742,14384664,14384696,61,65.591398,32,34.408602,190.625,52.459016,,15,46
62,14384742,14384836,14384789,14384820,63,67.021277,31,32.978723,203.225806,49.206349,,47,16
63,14384836,14384898,14384867,14384883,46,74.193548,16,25.806452,287.5,34.782609,,31,15
64,14384898,14384992,14384945,14384961,78,82.978723,16,17.021277,487.5,20.512821,,47,31
65,14384992,14385039,14385008,14385039,16,34.042553,31,65.957447,51.612903,193.75,,16,0
66,14385039,14385148,14385086,14385101,94,86.238532,15,13.761468,626.666667,15.957447,,47,47
67,14385148,14385195,14385164,14385179,32,68.085106,15,31.914894,213.333333,46.875,,16,16
68,14385195,14385288,14385226,14385257,62,66.666667,31,33.333333,200,50,,31,31
69,14385288,14385335,14385304,14385320,31,65.957447,16,34.042553,193.75,51.612903,,16,15
70,14385335,14385444,14385382,14385398,93,85.321101,16,14.678899,581.25,17.204301,,47,46
71,14385444,14385491,14385444,14385476,15,31.914894,32,68.085106,46.875,213.333333,,0,15
72,14385491,14385585,14385522,14385538,78,82.978723,16,17.021277,487.5,20.512821,,31,47
73,14385585,14385647,14385600,14385616,46,74.193548,16,25.806452,287.5,34.782609,,15,31
74,14385647,14385741,14385678,14385694,78,82.978723,16,17.021277,487.5,20.512821,,31,47
75,14385741,14385788,14385741,14385772,16,34.042553,31,65.957447,51.612903,193.75,,0,16
76,14385788,14385897,14385819,14385834,94,86.238532,15,13.761468,626.666667,15.957447,,31,63
77,14385897,14385990,14385944,14385959,78,83.870968,15,16.129032,520,19.230769,,47,31
78,14385990,14386037,14386022,14386037,32,68.085106,15,31.914894,213.333333,46.875,,32,0
79,14386037,14386147,14386084,14386115,79,71.818182,31,28.181818,254.83871,39.240506,,47,32
80,14386147,14386193,14386162,14386178,30,65.217391,16,34.782609,187.5,53.333333,,15,15
81,14386193,14386287,14386240,14386256,78,82.978723,16,17.021277,487.5,20.512821,,47,31
82,14386287,14386349,14386303,14386334,31,50,31,50,100,100,,16,15
83,14386349,14386443,14386381,14386427,48,51.06383,46,48.93617,104.347826,95.833333,,32,16
84,14386443,14386537,14386474,14386505,63,67.021277,31,32.978723,203.225806,49.206349,,31,32
85,14386537,14386599,14386552,14386568,46,74.193548,16,25.806452,287.5,34.782609,,15,31
86,14386599,14386693,14386630,14386646,78,82.978723,16,17.021277,487.5,20.512821,,31,47
87,14386693,14386739,14386693,14386724,15,32.608696,31,67.391304,48.387097,206.666667,,0,15
88,14386739,14386849,14386771,14386802,79,71.818182,31,28.181818,254.83871,39.240506,,32,47
89,14386849,14386895,14386849,14386864,31,67.391304,15,32.608696,206.666667,48.387097,,0,31
90,14386895,14386942,14386911,14386942,16,34.042553,31,65.957447,51.612903,193.75,,16,0
91,14386942,14387036,14386989,14387005,78,82.978723,16,17.021277,487.5,20.512821,,47,31
92,14387036,14387098,14387067,14387083,46,74.193548,16,25.806452,287.5,34.782609,,31,15
93,14387098,14387192,14387129,14387161,62,65.957447,32,34.042553,193.75,51.612903,,31,31
94,14387192,14387239,14387207,14387223,31,65.957447,16,34.042553,193.75,51.612903,,15,16
95,14387239,14387348,14387270,14387301,78,71.559633,31,28.440367,251.612903,39.74359,,31,47
96,14387348,14387395,14387348,14387379,16,34.042553,31,65.957447,51.612903,193.75,,0,16
97,14387395,14387488,14387426,14387441,78,83.870968,15,16.129032,520,19.230769,,31,47
98,14387488,14387535,14387504,14387519,32,68.085106,15,31.914894,213.333333,46.875,,16,16
99,14387535,14387597,14387566,14387597,31,50,31,50,100,100,,31,0
100,14387597,14387691,14387644,14387660,78,82.978723,16,17.021277,487.5,20.512821,,47,31
101,14387691,14387738,14387707,14387738,16,34.042553,31,65.957447,51.612903,193.75,,16,0
102,14387738,14387847,14387785,14387816,78,71.559633,31,28.440367,251.612903,39.74359,,47,31
103,14387847,14387894,14387863,14387878,32,68.085106,15,31.914894,213.333333,46.875,,16,16
104,14387894,14387987,14387925,14387956,62,66.666667,31,33.333333,200,50,,31,31
105,14387987,14388050,14388003,14388019,47,74.603175,16,25.396825,293.75,34.042553,,16,31
106,14388050,14388143,14388081,14388097,77,82.795699,16,17.204301,481.25,20.779221,,31,46
107,14388143,14388190,14388143,14388175,15,31.914894,32,68.085106,46.875,213.333333,,0,15
108,14388190,14388299,14388221,14388253,77,70.642202,32,29.357798,240.625,41.558442,,31,46
109,14388299,14388346,14388299,14388315,31,65.957447,16,34.042553,193.75,51.612903,,0,31
110,14388346,14388440,14388362,14388393,63,67.021277,31,32.978723,203.225806,49.206349,,16,47
111,14388440,14388549,14388487,14388518,78,71.559633,31,28.440367,251.612903,39.74359,,47,31
112,14388549,14388596,14388565,14388580,32,68.085106,15,31.914894,213.333333,46.875,,16,16
113,14388596,14388689,14388643,14388658,78,83.870968,15,16.129032,520,19.230769,,47,31
114,14388689,14388736,14388705,14388736,16,34.042553,31,65.957447,51.612903,193.75,,16,0
115,14388736,14388845,14388783,14388814,78,71.559633,31,28.440367,251.612903,39.74359,,47,31
116,14388845,14388892,14388861,14388877,31,65.957447,16,34.042553,193.75,51.612903,,16,15
117,14388892,14388986,14388939,14388955,78,82.978723,16,17.021277,487.5,20.512821,,47,31
118,14388986,14389048,14389001,14389017,46,74.193548,16,25.806452,287.5,34.782609,,15,31
119,14389048,14389142,14389079,14389095,78,82.978723,16,17.021277,487.5,20.512821,,31,47
120,14389142,14389189,14389142,14389173,16,34.042553,31,65.957447,51.612903,193.75,,0,16
121,14389189,14389298,14389220,14389235,94,86.238532,15,13.761468,626.666667,15.957447,,31,63
122,14389298,14389391,14389345,14389360,78,83.870968,15,16.129032,520,19.230769,,47,31
123,14389391,14389438,14389423,14389438,32,68.085106,15,31.914894,213.333333,46.875,,32,0
124,14389438,14389547,14389485,14389516,78,71.559633,31,28.440367,251.612903,39.74359,,47,31
125,14389547,14389594,14389563,14389579,31,65.957447,16,34.042553,193.75,51.612903,,16,15
126,14389594,14389688,14389641,14389657,78,82.978723,16,17.021277,487.5,20.512821,,47,31
127,14389688,14389750,14389703,14389735,30,48.387097,32,51.612903,93.75,106.666667,,15,15
128,14389750,14389844,14389781,14389797,78,82.978723,16,17.021277,487.5,20.512821,,31,47
129,14389844,14389891,14389859,14389875,31,65.957447,16,34.042553,193.75,51.612903,,15,16
130,14389891,14390000,14389922,14389953,78,71.559633,31,28.440367,251.612903,39.74359,,31,47
131,14390000,14390047,14390000,14390015,32,68.085106,15,31.914894,213.333333,46.875,,0,32
132,14390047,14390140,14390078,14390093,78,83.870968,15,16.129032,520,19.230769,,31,47
133,14390140,14390187,14390140,14390171,16,34.042553,31,65.957447,51.612903,193.75,,0,16
134,14390187,14390296,14390218,14390249,78,71.559633,31,28.440367,251.612903,39.74359,,31,47
135,14390296,14390390,14390343,14390359,78,82.978723,16,17.021277,487.5,20.512821,,47,31
136,14390390,14390437,14390421,14390437,31,65.957447,16,34.042553,193.75,51.612903,,31,0
137,14390437,14390546,14390483,14390515,77,70.642202,32,29.357798,240.625,41.558442,,46,31
138,14390546,14390593,14390561,14390577,31,65.957447,16,34.042553,193.75,51.612903,,15,16
139,14390593,14390686,14390639,14390655,77,82.795699,16,17.204301,481.25,20.779221,,46,31
140,14390686,14390749,14390702,14390733,32,50.793651,31,49.206349,103.225806,96.875,,16,16
141,14390749,14390842,14390780,14390795,78,83.870968,15,16.129032,520,19.230769,,31,47
142,14390842,14390889,14390858,14390873,32,68.085106,15,31.914894,213.333333,46.875,,16,16
143,14390889,14390998,14390920,14390951,78,71.559633,31,28.440367,251.612903,39.74359,,31,47
144,14390998,14391045,14390998,14391014,31,65.957447,16,34.042553,193.75,51.612903,,0,31
145,14391045,14391139,14391076,14391092,78,82.978723,16,17.021277,487.5,20.512821,,31,47
146,14391139,14391248,14391201,14391217,93,85.321101,16,14.678899,581.25,17.204301,,62,31
147,14391248,14391295,14391263,14391295,15,31.914894,32,68.085106,46.875,213.333333,,15,0
148,14391295,14391388,14391341,14391373,61,65.591398,32,34.408602,190.625,52.459016,,46,15
149,14391388,14391435,14391419,14391435,31,65.957447,16,34.042553,193.75,51.612903,,31,0
150,14391435,14391544,14391497,14391513,93,85.321101,16,14.678899,581.25,17.204301,,62,31
151,14391544,14391591,14391560,14391591,16,34.042553,31,65.957447,51.612903,193.75,,16,0
152,14391591,14391700,14391638,14391653,94,86.238532,15,13.761468,626.666667,15.957447,,47,47
153,14391700,14391747,14391716,14391731,32,68.085106,15,31.914894,213.333333,46.875,,16,16
154,14391747,14391841,14391778,14391809,63,67.021277,31,32.978723,203.225806,49.206349,,31,32
155,14391841,14391887,14391856,14391872,30,65.217391,16,34.782609,187.5,53.333333,,15,15
156,14391887,14391997,14391934,14391950,94,85.454545,16,14.545455,587.5,17.021277,,47,47
157,14391997,14392043,14391997,14392028,15,32.608696,31,67.391304,48.387097,206.666667,,0,15
158,14392043,14392137,14392075,14392106,63,67.021277,31,32.978723,203.225806,49.206349,,32,31
159,14392137,14392199,14392153,14392168,47,75.806452,15,24.193548,313.333333,31.914894,,16,31
160,14392199,14392246,14392215,14392246,16,34.042553,31,65.957447,51.612903,193.75,,16,0
161,14392246,14392340,14392293,14392309,78,82.978723,16,17.021277,487.5,20.512821,,47,31
162,14392340,14392387,14392371,14392387,31,65.957447,16,34.042553,193.75,51.612903,,31,0
163,14392387,14392496,14392433,14392449,93,85.321101,16,14.678899,581.25,17.204301,,46,47
164,14392496,14392543,14392511,14392527,31,65.957447,16,34.042553,193.75,51.612903,,15,16
165,14392543,14392636,14392574,14392605,62,66.666667,31,33.333333,200,50,,31,31
166,14392636,14392699,14392652,14392683,32,50.793651,31,49.206349,103.225806,96.875,,16,16
167,14392699,14392792,14392730,14392745,78,83.870968,15,16.129032,520,19.230769,,31,47
168,14392792,14392839,14392792,14392823,16,34.042553,31,65.957447,51.612903,193.75,,0,16
169,14392839,14392948,14392870,14392901,78,71.559633,31,28.440367,251.612903,39.74359,,31,47
170,14392948,14392995,14392948,14392964,31,65.957447,16,34.042553,193.75,51.612903,,0,31
171,14392995,14393089,14393026,14393042,78,82.978723,16,17.021277,487.5,20.512821,,31,47
172,14393089,14393198,14393135,14393167,77,70.642202,32,29.357798,240.625,41.558442,,46,31
173,14393198,14393245,14393213,14393229,31,65.957447,16,34.042553,193.75,51.612903,,15,16
174,14393245,14393338,14393291,14393307,77,82.795699,16,17.204301,481.25,20.779221,,46,31
175,14393338,14393385,14393354,14393385,16,34.042553,31,65.957447,51.612903,193.75,,16,0
176,14393385,14393494,14393432,14393463,78,71.559633,31,28.440367,251.612903,39.74359,,47,31
177,14393494,14393541,14393510,14393525,32,68.085106,15,31.914894,213.333333,46.875,,16,16
178,14393541,14393650,14393588,14393603,94,86.238532,15,13.761468,626.666667,15.957447,,47,47
179,14393650,14393697,14393650,14393681,16,34.042553,31,65.957447,51.612903,193.75,,0,16
180,14393697,14393791,14393728,14393759,63,67.021277,31,32.978723,203.225806,49.206349,,31,32
181,14393791,14393837,14393806,14393822,30,65.217391,16,34.782609,187.5,53.333333,,15,15
182,14393837,14393947,14393884,14393900,94,85.454545,16,14.545455,587.5,17.021277,,47,47
183,14393947,14393993,14393947,14393978,15,32.608696,31,67.391304,48.387097,206.666667,,0,15
184,14393993,14394087,14394025,14394040,79,84.042553,15,15.957447,526.666667,18.987342,,32,47
185,14394087,14394149,14394103,14394118,47,75.806452,15,24.193548,313.333333,31.914894,,16,31
186,14394149,14394243,14394165,14394196,63,67.021277,31,32.978723,203.225806,49.206349,,16,47
187,14394243,14394337,14394290,14394305,79,84.042553,15,15.957447,526.666667,18.987342,,47,32
188,14394337,14394399,14394352,14394383,31,50,31,50,100,100,,15,16
189,14394399,14394493,14394430,14394446,78,82.978723,16,17.021277,487.5,20.512821,,31,47
190,14394493,14394539,14394493,14394508,31,67.391304,15,32.608696,206.666667,48.387097,,0,31
191,14394539,14394586,14394571,14394586,32,68.085106,15,31.914894,213.333333,46.875,,32,0
192,14394586,14394695,14394633,14394649,93,85.321101,16,14.678899,581.25,17.204301,,47,46
193,14394695,14394742,14394695,14394711,31,65.957447,16,34.042553,193.75,51.612903,,0,31
194,14394742,14394789,14394773,14394789,31,65.957447,16,34.042553,193.75,51.612903,,31,0
195,14394789,14394898,14394836,14394851,94,86.238532,15,13.761468,626.666667,15.957447,,47,47
196,14394898,14394945,14394898,14394929,16,34.042553,31,65.957447,51.612903,193.75,,0,16
197,14394945,14395039,14394976,14395007,63,67.021277,31,32.978723,203.225806,49.206349,,31,32
198,14395039,14395085,14395054,14395070,30,65.217391,16,34.782609,187.5,53.333333,,15,15
199,14395085,14395195,14395132,14395148,94,85.454545,16,14.545455,587.5,17.021277,,47,47
200,14395195,14395241,14395195,14395226,15,32.608696,31,67.391304,48.387097,206.666667,,0,15
201,14395241,14395351,14395273,14395288,95,86.363636,15,13.636364,633.333333,15.789474,,32,63
202,14395351,14395444,14395397,14395413,77,82.795699,16,17.204301,481.25,20.779221,,46,31
203,14395444,14395491,14395460,14395491,16,34.042553,31,65.957447,51.612903,193.75,,16,0
204,14395491,14395600,14395538,14395569,78,71.559633,31,28.440367,251.612903,39.74359,,47,31
205,14395600,14395647,14395616,14395631,32,68.085106,15,31.914894,213.333333,46.875,,16,16
206,14395647,14395741,14395694,14395709,79,84.042553,15,15.957447,526.666667,18.987342,,47,32
207,14395741,14395787,14395756,14395787,15,32.608696,31,67.391304,48.387097,206.666667,,15,0
208,14395787,14395897,14395834,14395850,94,85.454545,16,14.545455,587.5,17.021277,,47,47
209,14395897,14395943,14395897,14395928,15,32.608696,31,67.391304,48.387097,206.666667,,0,15
210,14395943,14396037,14395975,14396006,63,67.021277,31,32.978723,203.225806,49.206349,,32,31
211,14396037,14396099,14396053,14396068,47,75.806452,15,24.193548,313.333333,31.914894,,16,31
212,14396099,14396193,14396115,14396146,63,67.021277,31,32.978723,203.225806,49.206349,,16,47
213,14396193,14396287,14396240,14396271,63,67.021277,31,32.978723,203.225806,49.206349,,47,16
214,14396287,14396349,14396318,14396333,47,75.806452,15,24.193548,313.333333,31.914894,,31,16
215,14396349,14396443,14396380,14396411,63,67.021277,31,32.978723,203.225806,49.206349,,31,32
216,14396443,14396489,14396458,14396489,15,32.608696,31,67.391304,48.387097,206.666667,,15,0
217,14396489,14396599,14396536,14396552,94,85.454545,16,14.545455,587.5,17.021277,,47,47
218,14396599,14396645,14396599,14396630,15,32.608696,31,67.391304,48.387097,206.666667,,0,15
219,14396645,14396739,14396677,14396708,63,67.021277,31,32.978723,203.225806,49.206349,,32,31
220,14396739,14396786,14396755,14396770,32,68.085106,15,31.914894,213.333333,46.875,,16,16
221,14396786,14396895,14396833,14396848,94,86.238532,15,13.761468,626.666667,15.957447,,47,47
222,14396895,14396942,14396895,14396926,16,34.042553,31,65.957447,51.612903,193.75,,0,16
223,14396942,14397035,14396973,14396989,77,82.795699,16,17.204301,481.25,20.779221,,31,46
224,14397035,14397098,14397051,14397067,47,74.603175,16,25.396825,293.75,34.042553,,16,31
225,14397098,14397191,14397113,14397145,61,65.591398,32,34.408602,190.625,52.459016,,15,46
226,14397191,14397301,14397238,14397269,79,71.818182,31,28.181818,254.83871,39.240506,,47,32
227,14397301,14397347,14397316,14397347,15,32.608696,31,67.391304,48.387097,206.666667,,15,0
228,14397347,14397441,14397394,14397410,78,82.978723,16,17.021277,487.5,20.512821,,47,31
229,14397441,14397488,14397457,14397488,16,34.042553,31,65.957447,51.612903,193.75,,16,0
230,14397488,14397597,14397535,14397566,78,71.559633,31,28.440367,251.612903,39.74359,,47,31
231,14397597,14397644,14397613,14397628,32,68.085106,15,31.914894,213.333333,46.875,,16,16
232,14397644,14397737,14397675,14397706,62,66.666667,31,33.333333,200,50,,31,31
233,14397737,14397800,14397753,14397784,32,50.793651,31,49.206349,103.225806,96.875,,16,16
234,14397800,14397893,14397831,14397847,77,82.795699,16,17.204301,481.25,20.779221,,31,46
235,14397893,14397940,14397893,14397925,15,31.914894,32,68.085106,46.875,213.333333,,0,15
236,14397940,14398049,14397971,14398003,77,70.642202,32,29.357798,240.625,41.558442,,31,46
237,14398049,14398096,14398049,14398065,31,65.957447,16,34.042553,193.75,51.612903,,0,31
238,14398096,14398190,14398127,14398143,78,82.978723,16,17.021277,487.5,20.512821,,31,47
239,14398190,14398299,14398237,14398268,78,71.559633,31,28.440367,251.612903,39.74359,,47,31
240,14398299,14398346,14398315,14398330,32,68.085106,15,31.914894,213.333333,46.875,,16,16
241,14398346,14398439,14398377,14398408,62,66.666667,31,33.333333,200,50,,31,31
242,14398439,14398486,14398455,14398471,31,65.957447,16,34.042553,193.75,51.612903,,16,15
243,14398486,14398595,14398533,14398549,93,85.321101,16,14.678899,581.25,17.204301,,47,46
244,14398595,14398642,14398595,14398627,15,31.914894,32,68.085106,46.875,213.333333,,0,15
245,14398642,14398736,14398673,14398705,62,65.957447,32,34.042553,193.75,51.612903,,31,31
246,14398736,14398798,14398751,14398767,46,74.193548,16,25.806452,287.5,34.782609,,15,31
247,14398798,14398892,14398814,14398845,63,67.021277,31,32.978723,203.225806,49.206349,,16,47
248,14398892,14398985,14398939,14398970,62,66.666667,31,33.333333,200,50,,47,15
249,14398985,14399048,14399017,14399032,48,76.190476,15,23.809524,320,31.25,,32,16
250,14399048,14399141,14399079,14399110,62,66.666667,31,33.333333,200,50,,31,31
251,14399141,14399188,14399157,14399188,16,34.042553,31,65.957447,51.612903,193.75,,16,0
252,14399188,14399297,14399235,14399251,93,85.321101,16,14.678899,581.25,17.204301,,47,46
253,14399297,14399344,14399297,14399329,15,31.914894,32,68.085106,46.875,213.333333,,0,15
254,14399344,14399438,14399375,14399407,62,65.957447,32,34.042553,193.75,51.612903,,31,31
255,14399438,14399500,14399453,14399469,46,74.193548,16,25.806452,287.5,34.782609,,15,31
256,14399500,14399594,14399531,14399547,78,82.978723,16,17.021277,487.5,20.512821,,31,47
257,14399594,14399641,14399594,14399625,16,34.042553,31,65.957447,51.612903,193.75,,0,16
258,14399641,14399750,14399672,14399687,94,86.238532,15,13.761468,626.666667,15.957447,,31,63
259,14399750,14399797,14399750,14399765,32,68.085106,15,31.914894,213.333333,46.875,,0,32
260,14399797,14399890,14399812,14399843,62,66.666667,31,33.333333,200,50,,15,47
261,14399890,14399999,14399937,14399968,78,71.559633,31,28.440367,251.612903,39.74359,,47,31
262,14399999,14400046,14400015,14400046,16,34.042553,31,65.957447,51.612903,193.75,,16,0
263,14400046,14400140,14400093,14400109,78,82.978723,16,17.021277,487.5,20.512821,,47,31
264,14400140,14400187,14400155,14400187,15,31.914894,32,68.085106,46.875,213.333333,,15,0
265,14400187,14400296,14400233,14400265,77,70.642202,32,29.357798,240.625,41.558442,,46,31
266,14400296,14400343,14400311,14400327,31,65.957447,16,34.042553,193.75,51.612903,,15,16
267,14400343,14400436,14400389,14400405,77,82.795699,16,17.204301,481.25,20.779221,,46,31
268,14400436,14400499,14400452,14400483,32,50.793651,31,49.206349,103.225806,96.875,,16,16
269,14400499,14400592,14400530,14400545,78,83.870968,15,16.129032,520,19.230769,,31,47
270,14400592,14400639,14400608,14400623,32,68.085106,15,31.914894,213.333333,46.875,,16,16
271,14400639,14400748,14400670,14400701,78,71.559633,31,28.440367,251.612903,39.74359,,31,47
272,14400748,14400795,14400748,14400779,16,34.042553,31,65.957447,51.612903,193.75,,0,16
273,14400795,14400889,14400826,14400842,78,82.978723,16,17.021277,487.5,20.512821,,31,47
274,14400889,14400935,14400889,14400920,15,32.608696,31,67.391304,48.387097,206.666667,,0,15
275,14400935,14400998,14400967,14400998,32,50.793651,31,49.206349,103.225806,96.875,,32,0
276,14400998,14401091,14401045,14401060,78,83.870968,15,16.129032,520,19.230769,,47,31
277,14401091,14401138,14401107,14401138,16,34.042553,31,65.957447,51.612903,193.75,,16,0
278,14401138,14401247,14401185,14401201,93,85.321101,16,14.678899,581.25,17.204301,,47,46
279,14401247,14401294,14401263,14401279,31,65.957447,16,34.042553,193.75,51.612903,,16,15
280,14401294,14401388,14401325,14401357,62,65.957447,32,34.042553,193.75,51.612903,,31,31
281,14401388,14401450,14401403,14401435,30,48.387097,32,51.612903,93.75,106.666667,,15,15
282,14401450,14401544,14401481,14401513,62,65.957447,32,34.042553,193.75,51.612903,,31,31
283,14401544,14401591,14401559,14401575,31,65.957447,16,34.042553,193.75,51.612903,,15,16
284,14401591,14401700,14401637,14401653,93,85.321101,16,14.678899,581.25,17.204301,,46,47
285,14401700,14401747,14401700,14401731,16,34.042553,31,65.957447,51.612903,193.75,,0,16
286,14401747,14401840,14401778,14401809,62,66.666667,31,33.333333,200,50,,31,31
287,14401840,14401887,14401856,14401871,32,68.085106,15,31.914894,213.333333,46.875,,16,16
288,14401887,14401996,14401918,14401949,78,71.559633,31,28.440367,251.612903,39.74359,,31,47
289,14401996,14402043,14401996,14402027,16,34.042553,31,65.957447,51.612903,193.75,,0,16
290,14402043,14402137,14402074,14402090,78,82.978723,16,17.021277,487.5,20.512821,,31,47
291,14402137,14402246,14402199,14402215,93,85.321101,16,14.678899,581.25,17.204301,,62,31
292,14402246,14402293,14402261,14402293,15,31.914894,32,68.085106,46.875,213.333333,,15,0
293,14402293,14402386,14402339,14402371,61,65.591398,32,34.408602,190.625,52.459016,,46,15
294,14402386,14402449,14402417,14402433,47,74.603175,16,25.396825,293.75,34.042553,,31,16
295,14402449,14402542,14402480,14402511,62,66.666667,31,33.333333,200,50,,31,31
296,14402542,14402589,14402558,14402589,16,34.042553,31,65.957447,51.612903,193.75,,16,0
297,14402589,14402698,14402636,14402651,94,86.238532,15,13.761468,626.666667,15.957447,,47,47
298,14402698,14402745,14402698,14402729,16,34.042553,31,65.957447,51.612903,193.75,,0,16
299,14402745,14402839,14402776,14402792,78,82.978723,16,17.021277,487.5,20.512821,,31,47
300,14402839,14402901,14402854,14402870,46,74.193548,16,25.806452,287.5,34.782609,,15,31
301,14402901,14402995,14402917,14402948,63,67.021277,31,32.978723,203.225806,49.206349,,16,47
302,14402995,14403088,14403041,14403073,61,65.591398,32,34.408602,190.625,52.459016,,46,15
303,14403088,14403151,14403119,14403135,47,74.603175,16,25.396825,293.75,34.042553,,31,16
304,14403151,14403244,14403197,14403213,77,82.795699,16,17.204301,481.25,20.779221,,46,31
305,14403244,14403291,14403260,14403291,16,34.042553,31,65.957447,51.612903,193.75,,16,0
306,14403291,14403400,14403338,14403353,94,86.238532,15,13.761468,626.666667,15.957447,,47,47
307,14403400,14403447,14403416,14403431,32,68.085106,15,31.914894,213.333333,46.875,,16,16
308,14403447,14403541,14403478,14403509,63,67.021277,31,32.978723,203.225806,49.206349,,31,32
309,14403541,14403587,14403556,14403572,30,65.217391,16,34.782609,187.5,53.333333,,15,15
310,14403587,14403697,14403634,14403650,94,85.454545,16,14.545455,587.5,17.021277,,47,47
311,14403697,14403743,14403697,14403728,15,32.608696,31,67.391304,48.387097,206.666667,,0,15
312,14403743,14403837,14403775,14403790,79,84.042553,15,15.957447,526.666667,18.987342,,32,47
313,14403837,14403899,14403853,14403868,47,75.806452,15,24.193548,313.333333,31.914894,,16,31
314,14403899,14403993,14403915,14403946,63,67.021277,31,32.978723,203.225806,49.206349,,16,47
315,14403993,14404087,14404040,14404071,63,67.021277,31,32.978723,203.225806,49.206349,,47,16
316,14404087,14404149,14404118,14404133,47,75.806452,15,24.193548,313.333333,31.914894,,31,16
317,14404149,14404243,14404196,14404211,79,84.042553,15,15.957447,526.666667,18.987342,,47,32
318,14404243,14404289,14404258,14404289,15,32.608696,31,67.391304,48.387097,206.666667,,15,0
319,14404289,14404399,14404336,14404352,94,85.454545,16,14.545455,587.5,17.021277,,47,47
320,14404399,14404445,14404414,14404430,30,65.217391,16,34.782609,187.5,53.333333,,15,15
321,14404445,14404539,14404477,14404508,63,67.021277,31,32.978723,203.225806,49.206349,,32,31
322,14404539,14404586,14404555,14404570,32,68.085106,15,31.914894,213.333333,46.875,,16,16
323,14404586,14404695,14404633,14404648,94,86.238532,15,13.761468,626.666667,15.957447,,47,47
324,14404695,14404742,14404695,14404726,16,34.042553,31,65.957447,51.612903,193.75,,0,16
325,14404742,14404851,14404773,14404804,78,71.559633,31,28.440367,251.612903,39.74359,,31,47
326,14404851,14404898,14404851,14404867,31,65.957447,16,34.042553,193.75,51.612903,,0,31
327,14404898,14404991,14404913,14404945,61,65.591398,32,34.408602,190.625,52.459016,,15,46
328,14404991,14405101,14405038,14405069,79,71.818182,31,28.181818,254.83871,39.240506,,47,32
329,14405101,14405147,14405116,14405132,30,65.217391,16,34.782609,187.5,53.333333,,15,15
330,14405147,14405241,14405194,14405210,78,82.978723,16,17.021277,487.5,20.512821,,47,31
331,14405241,14405288,14405257,14405288,16,34.042553,31,65.957447,51.612903,193.75,,16,0
332,14405288,14405397,14405335,14405350,94,86.238532,15,13.761468,626.666667,15.957447,,47,47
333,14405397,14405444,14405413,14405428,32,68.085106,15,31.914894,213.333333,46.875,,16,16
334,14405444,14405537,14405475,14405506,62,66.666667,31,33.333333,200,50,,31,31
335,14405537,14405600,14405553,14405569,47,74.603175,16,25.396825,293.75,34.042553,,16,31
336,14405600,14405693,14405631,14405647,77,82.795699,16,17.204301,481.25,20.779221,,31,46
337,14405693,14405740,14405709,14405725,31,65.957447,16,34.042553,193.75,51.612903,,16,15
338,14405740,14405849,14405771,14405803,77,70.642202,32,29.357798,240.625,41.558442,,31,46
339,14405849,14405896,14405849,14405881,15,31.914894,32,68.085106,46.875,213.333333,,0,15
340,14405896,14405990,14405927,14405943,78,82.978723,16,17.021277,487.5,20.512821,,31,47
341,14405990,14406037,14406005,14406021,31,65.957447,16,34.042553,193.75,51.612903,,15,16
342,14406037,14406146,14406068,14406099,78,71.559633,31,28.440367,251.612903,39.74359,,31,47
343,14406146,14406239,14406193,14406224,62,66.666667,31,33.333333,200,50,,47,15
344,14406239,14406286,14406271,14406286,32,68.085106,15,31.914894,213.333333,46.875,,32,0
345,14406286,14406395,14406333,14406364,78,71.559633,31,28.440367,251.612903,39.74359,,47,31
346,14406395,14406442,14406411,14406442,16,34.042553,31,65.957447,51.612903,193.75,,16,0
347,14406442,14406536,14406489,14406505,78,82.978723,16,17.021277,487.5,20.512821,,47,31
348,14406536,14406598,14406551,14406583,30,48.387097,32,51.612903,93.75,106.666667,,15,15
349,14406598,14406692,14406629,14406661,62,65.957447,32,34.042553,193.75,51.612903,,31,31
350,14406692,14406739,14406707,14406723,31,65.957447,16,34.042553,193.75,51.612903,,15,16
351,14406739,14406848,14406770,14406801,78,71.559633,31,28.440367,251.612903,39.74359,,31,47
352,14406848,14406895,14406848,14406879,16,34.042553,31,65.957447,51.612903,193.75,,0,16
353,14406895,14406988,14406926,14406941,78,83.870968,15,16.129032,520,19.230769,,31,47
354,14406988,14407051,14407004,14407019,48,76.190476,15,23.809524,320,31.25,,16,32
355,14407051,14407144,14407066,14407097,62,66.666667,31,33.333333,200,50,,15,47
356,14407144,14407238,14407191,14407222,63,67.021277,31,32.978723,203.225806,49.206349,,47,16
357,14407238,14407300,14407269,14407285,46,74.193548,16,25.806452,287.5,34.782609,,31,15
358,14407300,14407394,14407347,14407363,78,82.978723,16,17.021277,487.5,20.512821,,47,31
359,14407394,14407441,14407409,14407441,15,31.914894,32,68.085106,46.875,213.333333,,15,0
360,14407441,14407550,14407487,14407503,93,85.321101,16,14.678899,581.25,17.204301,,46,47
361,14407550,14407597,14407565,14407581,31,65.957447,16,34.042553,193.75,51.612903,,15,16
362,14407597,14407690,14407628,14407659,62,66.666667,31,33.333333,200,50,,31,31
363,14407690,14407737,14407706,14407721,32,68.085106,15,31.914894,213.333333,46.875,,16,16
364,14407737,14407846,14407784,14407799,94,86.238532,15,13.761468,626.666667,15.957447,,47,47
365,14407846,14407893,14407846,14407877,16,34.042553,31,65.957447,51.612903,193.75,,0,16
366,14407893,14407987,14407924,14407940,78,82.978723,16,17.021277,487.5,20.512821,,31,47
367,14407987,14408049,14408002,14408018,46,74.193548,16,25.806452,287.5,34.782609,,15,31
368,14408049,14408143,14408065,14408096,63,67.021277,31,32.978723,203.225806,49.206349,,16,47
369,14408143,14408236,14408189,14408221,61,65.591398,32,34.408602,190.625,52.459016,,46,15
370,14408236,14408299,14408267,14408283,47,74.603175,16,25.396825,293.75,34.042553,,31,16
371,14408299,14408392,14408345,14408361,77,82.795699,16,17.204301,481.25,20.779221,,46,31
372,14408392,14408439,14408408,14408439,16,34.042553,31,65.957447,51.612903,193.75,,16,0
373,14408439,14408548,14408486,14408501,94,86.238532,15,13.761468,626.666667,15.957447,,47,47
374,14408548,14408595,14408564,14408579,32,68.085106,15,31.914894,213.333333,46.875,,16,16
375,14408595,14408689,14408626,14408657,63,67.021277,31,32.978723,203.225806,49.206349,,31,32
376,14408689,14408751,14408704,14408720,46,74.193548,16,25.806452,287.5,34.782609,,15,31
377,14408751,14408845,14408782,14408798,78,82.978723,16,17.021277,487.5,20.512821,,31,47
378,14408845,14408891,14408845,14408876,15,32.608696,31,67.391304,48.387097,206.666667,,0,15
379,14408891,14409001,14408923,14408938,95,86.363636,15,13.636364,633.333333,15.789474,,32,63
380,14409001,14409047,14409001,14409016,31,67.391304,15,32.608696,206.666667,48.387097,,0,31
381,14409047,14409141,14409063,14409094,63,67.021277,31,32.978723,203.225806,49.206349,,16,47
382,14409141,14409250,14409188,14409219,78,71.559633,31,28.440367,251.612903,39.74359,,47,31
383,14409250,14409297,14409266,14409297,16,34.042553,31,65.957447,51.612903,193.75,,16,0
384,14409297,14409391,14409344,14409359,79,84.042553,15,15.957447,526.666667,18.987342,,47,32
385,14409391,14409437,14409406,14409437,15,32.608696,31,67.391304,48.387097,206.666667,,15,0
386,14409437,14409547,14409484,14409515,79,71.818182,31,28.181818,254.83871,39.240506,,47,32
387,14409547,14409593,14409562,14409578,30,65.217391,16,34.782609,187.5,53.333333,,15,15
388,14409593,14409687,14409640,14409656,78,82.978723,16,17.021277,487.5,20.512821,,47,31
389,14409687,14409749,14409703,14409734,31,50,31,50,100,100,,16,15
390,14409749,14409843,14409781,14409812,63,67.021277,31,32.978723,203.225806,49.206349,,32,31
391,14409843,14409890,14409859,14409874,32,68.085106,15,31.914894,213.333333,46.875,,16,16
392,14409890,14409999,14409937,14409952,94,86.238532,15,13.761468,626.666667,15.957447,,47,47
393,14409999,14410046,14409999,14410030,16,34.042553,31,65.957447,51.612903,193.75,,0,16
394,14410046,14410139,14410077,14410093,77,82.795699,16,17.204301,481.25,20.779221,,31,46
395,14410139,14410186,14410155,14410171,31,65.957447,16,34.042553,193.75,51.612903,,16,15
396,14410186,14410295,14410217,14410249,77,70.642202,32,29.357798,240.625,41.558442,,31,46
397,14410295,14410389,14410342,14410358,78,82.978723,16,17.021277,487.5,20.512821,,47,31
398,14410389,14410451,14410420,14410436,46,74.193548,16,25.806452,287.5,34.782609,,31,15
399,14410451,14410545,14410483,14410514,63,67.021277,31,32.978723,203.225806,49.206349,,32,31
400,14410545,14410592,14410561,14410592,16,34.042553,31,65.957447,51.612903,193.75,,16,0
401,14410592,14410701,14410639,14410654,94,86.238532,15,13.761468,626.666667,15.957447,,47,47
402,14410701,14410748,14410717,14410732,32,68.085106,15,31.914894,213.333333,46.875,,16,16
403,14410748,14410841,14410779,14410810,62,66.666667,31,33.333333,200,50,,31,31
404,14410841,14410888,14410857,14410888,16,34.042553,31,65.957447,51.612903,193.75,,16,0
405,14410888,14410997,14410935,14410951,93,85.321101,16,14.678899,581.25,17.204301,,47,46
406,14410997,14411044,14410997,14411029,15,31.914894,32,68.085106,46.875,213.333333,,0,15
407,14411044,14411138,14411075,14411107,62,65.957447,32,34.042553,193.75,51.612903,,31,31
408,14411138,14411200,14411153,14411169,46,74.193548,16,25.806452,287.5,34.782609,,15,31
409,14411200,14411294,14411231,14411247,78,82.978723,16,17.021277,487.5,20.512821,,31,47
410,14411294,14411341,14411294,14411325,16,34.042553,31,65.957447,51.612903,193.75,,0,16
411,14411341,14411450,14411372,14411387,94,86.238532,15,13.761468,626.666667,15.957447,,31,63
412,14411450,14411543,14411497,14411512,78,83.870968,15,16.129032,520,19.230769,,47,31
413,14411543,14411590,14411559,14411590,16,34.042553,31,65.957447,51.612903,193.75,,16,0
414,14411590,14411699,14411637,14411668,78,71.559633,31,28.440367,251.612903,39.74359,,47,31
415,14411699,14411746,14411715,14411731,31,65.957447,16,34.042553,193.75,51.612903,,16,15
416,14411746,14411840,14411793,14411809,78,82.978723,16,17.021277,487.5,20.512821,,47,31
417,14411840,14411887,14411855,14411887,15,31.914894,32,68.085106,46.875,213.333333,,15,0
418,14411887,14411996,14411933,14411965,77,70.642202,32,29.357798,240.625,41.558442,,46,31
419,14411996,14412043,14412011,14412027,31,65.957447,16,34.042553,193.75,51.612903,,15,16
420,14412043,14412136,14412089,14412105,77,82.795699,16,17.204301,481.25,20.779221,,46,31
421,14412136,14412199,14412152,14412183,32,50.793651,31,49.206349,103.225806,96.875,,16,16
422,14412199,14412292,14412230,14412245,78,83.870968,15,16.129032,520,19.230769,,31,47
423,14412292,14412339,14412308,14412323,32,68.085106,15,31.914894,213.333333,46.875,,16,16
424,14412339,14412448,14412386,14412401,94,86.238532,15,13.761468,626.666667,15.957447,,47,47
425,14412448,14412495,14412448,14412479,16,34.042553,31,65.957447,51.612903,193.75,,0,16
426,14412495,14412589,14412526,14412542,78,82.978723,16,17.021277,487.5,20.512821,,31,47
427,14412589,14412651,14412604,14412620,46,74.193548,16,25.806452,287.5,34.782609,,15,31
428,14412651,14412745,14412667,14412698,63,67.021277,31,32.978723,203.225806,49.206349,,16,47
429,14412745,14412838,14412791,14412823,61,65.591398,32,34.408602,190.625,52.459016,,46,15
430,14412838,14412901,14412869,14412885,47,74.603175,16,25.396825,293.75,34.042553,,31,16
431,14412901,14412994,14412947,14412963,77,82.795699,16,17.204301,481.25,20.779221,,46,31
432,14412994,14413041,14413010,14413041,16,34.042553,31,65.957447,51.612903,193.75,,16,0
433,14413041,14413150,14413088,14413103,94,86.238532,15,13.761468,626.666667,15.957447,,47,47
434,14413150,14413197,14413166,14413181,32,68.085106,15,31.914894,213.333333,46.875,,16,16
435,14413197,14413291,14413228,14413259,63,67.021277,31,32.978723,203.225806,49.206349,,31,32
436,14413291,14413337,14413306,14413322,30,65.217391,16,34.782609,187.5,53.333333,,15,15
437,14413337,14413447,14413369,14413400,79,71.818182,31,28.181818,254.83871,39.240506,,32,47
438,14413447,14413493,14413447,14413478,15,32.608696,31,67.391304,48.387097,206.666667,,0,15
439,14413493,14413587,14413525,14413540,79,84.042553,15,15.957447,526.666667,18.987342,,32,47
440,14413587,14413696,14413649,14413665,93,85.321101,16,14.678899,581.25,17.204301,,62,31
441,14413696,14413743,14413712,14413743,16,34.042553,31,65.957447,51.612903,193.75,,16,0
442,14413743,14413837,14413790,14413805,79,84.042553,15,15.957447,526.666667,18.987342,,47,32
443,14413837,14413899,14413868,14413883,47,75.806452,15,24.193548,313.333333,31.914894,,31,16
444,14413899,14413993,14413930,14413961,63,67.021277,31,32.978723,203.225806,49.206349,,31,32
445,14413993,14414039,14414008,14414024,30,65.217391,16,34.782609,187.5,53.333333,,15,15
446,14414039,14414149,14414086,14414102,94,85.454545,16,14.545455,587.5,17.021277,,47,47
447,14414149,14414195,14414149,14414180,15,32.608696,31,67.391304,48.387097,206.666667,,0,15
448,14414195,14414289,14414227,14414258,63,67.021277,31,32.978723,203.225806,49.206349,,32,31
449,14414289,14414351,14414305,14414320,47,75.806452,15,24.193548,313.333333,31.914894,,16,31
450,14414351,14414445,14414383,14414398,79,84.042553,15,15.957447,526.666667,18.987342,,32,47
451,14414445,14414492,14414445,14414476,16,34.042553,31,65.957447,51.612903,193.75,,0,16
452,14414492,14414601,14414523,14414539,93,85.321101,16,14.678899,581.25,17.204301,,31,62
453,14414601,14414648,14414601,14414617,31,65.957447,16,34.042553,193.75,51.612903,,0,31
454,14414648,14414741,14414663,14414695,61,65.591398,32,34.408602,190.625,52.459016,,15,46
455,14414741,14414851,14414788,14414819,79,71.818182,31,28.181818,254.83871,39.240506,,47,32
456,14414851,14414897,14414866,14414897,15,32.608696,31,67.391304,48.387097,206.666667,,15,0
457,14414897,14414991,14414944,14414960,78,82.978723,16,17.021277,487.5,20.512821,,47,31
458,14414991,14415038,14415007,14415038,16,34.042553,31,65.957447,51.612903,193.75,,16,0
459,14415038,14415147,14415085,14415100,94,86.238532,15,13.761468,626.666667,15.957447,,47,47
460,14415147,14415194,14415163,14415178,32,68.085106,15,31.914894,213.333333,46.875,,16,16
461,14415194,14415287,14415225,14415256,62,66.666667,31,33.333333,200,50,,31,31
462,14415287,14415350,14415303,14415334,32,50.793651,31,49.206349,103.225806,96.875,,16,16
463,14415350,14415443,14415381,14415397,77,82.795699,16,17.204301,481.25,20.779221,,31,46
464,14415443,14415490,14415459,14415475,31,65.957447,16,34.042553,193.75,51.612903,,16,15
465,14415490,14415599,14415521,14415553,77,70.642202,32,29.357798,240.625,41.558442,,31,46
466,14415599,14415646,14415599,14415615,31,65.957447,16,34.042553,193.75,51.612903,,0,31
467,14415646,14415740,14415677,14415693,78,82.978723,16,17.021277,487.5,20.512821,,31,47
468,14415740,14415787,14415740,14415771,16,34.042553,31,65.957447,51.612903,193.75,,0,16
469,14415787,14415849,14415818,14415833,47,75.806452,15,24.193548,313.333333,31.914894,,31,16
470,14415849,14415943,14415896,14415911,79,84.042553,15,15.957447,526.666667,18.987342,,47,32
471,14415943,14415989,14415958,14415989,15,32.608696,31,67.391304,48.387097,206.666667,,15,0
472,14415989,14416099,14416036,14416067,79,71.818182,31,28.181818,254.83871,39.240506,,47,32
473,14416099,14416145,14416114,14416130,30,65.217391,16,34.782609,187.5,53.333333,,15,15
474,14416145,14416239,14416192,14416208,78,82.978723,16,17.021277,487.5,20.512821,,47,31
475,14416239,14416301,14416255,14416286,31,50,31,50,100,100,,16,15
476,14416301,14416395,14416333,14416348,79,84.042553,15,15.957447,526.666667,18.987342,,32,47
477,14416395,14416442,14416411,14416426,32,68.085106,15,31.914894,213.333333,46.875,,16,16
478,14416442,14416551,14416473,14416504,78,71.559633,31,28.440367,251.612903,39.74359,,31,47
479,14416551,14416598,14416551,14416582,16,34.042553,31,65.957447,51.612903,193.75,,0,16
480,14416598,14416691,14416629,14416645,77,82.795699,16,17.204301,481.25,20.779221,,31,46
481,14416691,14416738,14416707,14416723,31,65.957447,16,34.042553,193.75,51.612903,,16,15
482,14416738,14416847,14416769,14416801,77,70.642202,32,29.357798,240.625,41.558442,,31,46
483,14416847,14416894,14416847,14416879,15,31.914894,32,68.085106,46.875,213.333333,,0,15
484,14416894,14416988,14416925,14416941,78,82.978723,16,17.021277,487.5,20.512821,,31,47
485,14416988,14417097,14417050,14417066,93,85.321101,16,14.678899,581.25,17.204301,,62,31
486,14417097,14417144,14417113,14417144,16,34.042553,31,65.957447,51.612903,193.75,,16,0
487,14417144,14417237,14417191,14417206,78,83.870968,15,16.129032,520,19.230769,,47,31
488,14417237,14417300,14417269,14417284,48,76.190476,15,23.809524,320,31.25,,32,16
489,14417300,14417394,14417331,14417362,63,67.021277,31,32.978723,203.225806,49.206349,,31,32
490,14417394,14417440,14417409,14417425,30,65.217391,16,34.782609,187.5,53.333333,,15,15
491,14417440,14417550,14417487,14417503,94,85.454545,16,14.545455,587.5,17.021277,,47,47
492,14417550,14417596,14417550,14417581,15,32.608696,31,67.391304,48.387097,206.666667,,0,15
493,14417596,14417690,14417628,14417643,79,84.042553,15,15.957447,526.666667,18.987342,,32,47
494,14417690,14417737,14417706,14417721,32,68.085106,15,31.914894,213.333333,46.875,,16,16
495,14417737,14417846,14417768,14417799,78,71.559633,31,28.440367,251.612903,39.74359,,31,47
496,14417846,14417940,14417893,14417924,63,67.021277,31,32.978723,203.225806,49.206349,,47,16
497,14417940,14418049,14417971,14418002,78,71.559633,31,28.440367,251.612903,39.74359,,31,47
498,14418049,14418142,14418096,14418111,78,83.870968,15,16.129032,520,19.230769,,47,31
499,14418142,14418189,14418174,14418189,32,68.085106,15,31.914894,213.333333,46.875,,32,0
500,14418189,14418298,14418236,14418267,78,71.559633,31,28.440367,251.612903,39.74359,,47,31
501,14418298,14418392,14418314,14418345,63,67.021277,31,32.978723,203.225806,49.206349,,16,47
502,14418392,14418501,14418439,14418470,78,71.559633,31,28.440367,251.612903,39.74359,,47,31
503,14418501,14418548,14418517,14418532,32,68.085106,15,31.914894,213.333333,46.875,,16,16
504,14418548,14418642,14418595,14418610,79,84.042553,15,15.957447,526.666667,18.987342,,47,32
505,14418642,14418688,14418657,14418688,15,32.608696,31,67.391304,48.387097,206.666667,,15,0
506,14418688,14418798,14418735,14418751,94,85.454545,16,14.545455,587.5,17.021277,,47,47
507,14418798,14418844,14418813,14418829,30,65.217391,16,34.782609,187.5,53.333333,,15,15
508,14418844,14418938,14418876,14418907,63,67.021277,31,32.978723,203.225806,49.206349,,32,31
509,14418938,14419000,14418954,14418969,47,75.806452,15,24.193548,313.333333,31.914894,,16,31
510,14419000,14419094,14419032,14419047,79,84.042553,15,15.957447,526.666667,18.987342,,32,47
511,14419094,14419141,14419094,14419125,16,34.042553,31,65.957447,51.612903,193.75,,0,16
512,14419141,14419250,14419172,14419188,93,85.321101,16,14.678899,581.25,17.204301,,31,62
513,14419250,14419344,14419297,14419312,79,84.042553,15,15.957447,526.666667,18.987342,,47,32
514,14419344,14419390,14419375,14419390,31,67.391304,15,32.608696,206.666667,48.387097,,31,0
515,14419390,14419500,14419437,14419468,79,71.818182,31,28.181818,254.83871,39.240506,,47,32
516,14419500,14419546,14419515,14419531,30,65.217391,16,34.782609,187.5,53.333333,,15,15
517,14419546,14419640,14419593,14419609,78,82.978723,16,17.021277,487.5,20.512821,,47,31
518,14419640,14419687,14419656,14419687,16,34.042553,31,65.957447,51.612903,193.75,,16,0
519,14419687,14419796,14419734,14419749,94,86.238532,15,13.761468,626.666667,15.957447,,47,47
520,14419796,14419843,14419812,14419827,32,68.085106,15,31.914894,213.333333,46.875,,16,16
521,14419843,14419952,14419874,14419905,78,71.559633,31,28.440367,251.612903,39.74359,,31,47
522,14419952,14419999,14419952,14419983,16,34.042553,31,65.957447,51.612903,193.75,,0,16
523,14419999,14420092,14420030,14420046,77,82.795699,16,17.204301,481.25,20.779221,,31,46
524,14420092,14420139,14420108,14420124,31,65.957447,16,34.042553,193.75,51.612903,,16,15
525,14420139,14420248,14420170,14420202,77,70.642202,32,29.357798,240.625,41.558442,,31,46
526,14420248,14420295,14420248,14420264,31,65.957447,16,34.042553,193.75,51.612903,,0,31
527,14420295,14420389,14420326,14420342,78,82.978723,16,17.021277,487.5,20.512821,,31,47
528,14420389,14420451,14420389,14420420,31,50,31,50,100,100,,0,31
529,14420451,14420498,14420467,14420498,16,34.042553,31,65.957447,51.612903,193.75,,16,0
530,14420498,14420592,14420545,14420560,79,84.042553,15,15.957447,526.666667,18.987342,,47,32
531,14420592,14420638,14420623,14420638,31,67.391304,15,32.608696,206.666667,48.387097,,31,0
532,14420638,14420748,14420685,14420716,79,71.818182,31,28.181818,254.83871,39.240506,,47,32
533,14420748,14420794,14420763,14420794,15,32.608696,31,67.391304,48.387097,206.666667,,15,0
534,14420794,14420888,14420841,14420857,78,82.978723,16,17.021277,487.5,20.512821,,47,31
535,14420888,14420950,14420904,14420935,31,50,31,50,100,100,,16,15
536,14420950,14421044,14420982,14421013,63,67.021277,31,32.978723,203.225806,49.206349,,32,31
537,14421044,14421091,14421060,14421075,32,68.085106,15,31.914894,213.333333,46.875,,16,16
538,14421091,14421200,14421122,14421153,78,71.559633,31,28.440367,251.612903,39.74359,,31,47
539,14421200,14421247,14421200,14421231,16,34.042553,31,65.957447,51.612903,193.75,,0,16
540,14421247,14421340,14421278,14421309,62,66.666667,31,33.333333,200,50,,31,31
541,14421340,14421387,14421356,14421372,31,65.957447,16,34.042553,193.75,51.612903,,16,15
542,14421387,14421496,14421418,14421450,77,70.642202,32,29.357798,240.625,41.558442,,31,46
543,14421496,14421543,14421496,14421512,31,65.957447,16,34.042553,193.75,51.612903,,0,31
544,14421543,14421637,14421574,14421590,78,82.978723,16,17.021277,487.5,20.512821,,31,47
545,14421637,14421746,14421699,14421715,93,85.321101,16,14.678899,581.25,17.204301,,62,31
546,14421746,14421793,14421762,14421793,16,34.042553,31,65.957447,51.612903,193.75,,16,0
547,14421793,14421902,14421840,14421855,94,86.238532,15,13.761468,626.666667,15.957447,,47,47
548,14421902,14421949,14421918,14421933,32,68.085106,15,31.914894,213.333333,46.875,,16,16
549,14421949,14422042,14421980,14422011,62,66.666667,31,33.333333,200,50,,31,31
550,14422042,14422089,14422058,14422089,16,34.042553,31,65.957447,51.612903,193.75,,16,0
551,14422089,14422198,14422136,14422152,93,85.321101,16,14.678899,581.25,17.204301,,47,46
552,14422198,14422245,14422214,14422230,31,65.957447,16,34.042553,193.75,51.612903,,16,15
553,14422245,14422339,14422276,14422308,62,65.957447,32,34.042553,193.75,51.612903,,31,31
554,14422339,14422401,14422354,14422370,46,74.193548,16,25.806452,287.5,34.782609,,15,31
555,14422401,14422495,14422432,14422448,78,82.978723,16,17.021277,487.5,20.512821,,31,47
556,14422495,14422542,14422495,14422526,16,34.042553,31,65.957447,51.612903,193.75,,0,16
557,14422542,14422651,14422573,14422588,94,86.238532,15,13.761468,626.666667,15.957447,,31,63
558,14422651,14422744,14422698,14422713,78,83.870968,15,16.129032,520,19.230769,,47,31
559,14422744,14422838,14422760,14422807,47,50,47,50,100,100,,16,31
560,14422838,14422900,14422854,14422885,31,50,31,50,100,100,,16,15
561,14422900,14422994,14422932,14422963,63,67.021277,31,32.978723,203.225806,49.206349,,32,31
562,14422994,14423041,14423010,14423025,32,68.085106,15,31.914894,213.333333,46.875,,16,16
563,14423041,14423150,14423072,14423103,78,71.559633,31,28.440367,251.612903,39.74359,,31,47
564,14423150,14423197,14423150,14423181,16,34.042553,31,65.957447,51.612903,193.75,,0,16
565,14423197,14423290,14423228,14423244,77,82.795699,16,17.204301,481.25,20.779221,,31,46
566,14423290,14423337,14423290,14423322,15,31.914894,32,68.085106,46.875,213.333333,,0,15
567,14423337,14423400,14423368,14423400,31,49.206349,32,50.793651,96.875,103.225806,,31,0
568,14423400,14423493,14423446,14423462,77,82.795699,16,17.204301,481.25,20.779221,,46,31
569,14423493,14423540,14423509,14423540,16,34.042553,31,65.957447,51.612903,193.75,,16,0
570,14423540,14423649,14423587,14423602,94,86.238532,15,13.761468,626.666667,15.957447,,47,47
571,14423649,14423696,14423665,14423680,32,68.085106,15,31.914894,213.333333,46.875,,16,16
572,14423696,14423790,14423727,14423758,63,67.021277,31,32.978723,203.225806,49.206349,,31,32
573,14423790,14423852,14423805,14423821,46,74.193548,16,25.806452,287.5,34.782609,,15,31
574,14423852,14423946,14423883,14423899,78,82.978723,16,17.021277,487.5,20.512821,,31,47
575,14423946,14423992,14423946,14423977,15,32.608696,31,67.391304,48.387097,206.666667,,0,15
576,14423992,14424102,14424024,14424055,79,71.818182,31,28.181818,254.83871,39.240506,,32,47
577,14424102,14424148,14424102,14424117,31,67.391304,15,32.608696,206.666667,48.387097,,0,31
578,14424148,14424242,14424180,14424195,79,84.042553,15,15.957447,526.666667,18.987342,,32,47
579,14424242,14424351,14424289,14424320,78,71.559633,31,28.440367,251.612903,39.74359,,47,31
580,14424351,14424398,14424367,14424398,16,34.042553,31,65.957447,51.612903,193.75,,16,0
581,14424398,14424492,14424445,14424460,79,84.042553,15,15.957447,526.666667,18.987342,,47,32
582,14424492,14424538,14424523,14424538,31,67.391304,15,32.608696,206.666667,48.387097,,31,0
583,14424538,14424648,14424585,14424616,79,71.818182,31,28.181818,254.83871,39.240506,,47,32
584,14424648,14424694,14424663,14424694,15,32.608696,31,67.391304,48.387097,206.666667,,15,0
585,14424694,14424788,14424741,14424757,78,82.978723,16,17.021277,487.5,20.512821,,47,31
586,14424788,14424850,14424819,14424835,46,74.193548,16,25.806452,287.5,34.782609,,31,15
587,14424850,14424944,14424882,14424913,63,67.021277,31,32.978723,203.225806,49.206349,,32,31
588,14424944,14424991,14424960,14424991,16,34.042553,31,65.957447,51.612903,193.75,,16,0
589,14424991,14425100,14425038,14425053,94,86.238532,15,13.761468,626.666667,15.957447,,47,47
590,14425100,14425147,14425116,14425131,32,68.085106,15,31.914894,213.333333,46.875,,16,16
591,14425147,14425240,14425178,14425209,62,66.666667,31,33.333333,200,50,,31,31
592,14425240,14425287,14425256,14425272,31,65.957447,16,34.042553,193.75,51.612903,,16,15
593,14425287,14425396,14425334,14425350,93,85.321101,16,14.678899,581.25,17.204301,,47,46
594,14425396,14425443,14425396,14425428,15,31.914894,32,68.085106,46.875,213.333333,,0,15
595,14425443,14425552,14425474,14425506,77,70.642202,32,29.357798,240.625,41.558442,,31,46
596,14425552,14425599,14425552,14425568,31,65.957447,16,34.042553,193.75,51.612903,,0,31
597,14425599,14425693,14425630,14425646,78,82.978723,16,17.021277,487.5,20.512821,,31,47
598,14425693,14425740,14425693,14425724,16,34.042553,31,65.957447,51.612903,193.75,,0,16
599,14425740,14425849,14425771,14425786,94,86.238532,15,13.761468,626.666667,15.957447,,31,63
600,14425849,14425942,14425896,14425911,78,83.870968,15,16.129032,520,19.230769,,47,31
601,14425942,14425989,14425974,14425989,32,68.085106,15,31.914894,213.333333,46.875,,32,0
602,14425989,14426098,14426036,14426067,78,71.559633,31,28.440367,251.612903,39.74359,,47,31
603,14426098,14426145,14426114,14426130,31,65.957447,16,34.042553,193.75,51.612903,,16,15
604,14426145,14426239,14426176,14426208,62,65.957447,32,34.042553,193.75,51.612903,,31,31
605,14426239,14426301,14426254,14426270,46,74.193548,16,25.806452,287.5,34.782609,,15,31
606,14426301,14426395,14426332,14426348,78,82.978723,16,17.021277,487.5,20.512821,,31,47
607,14426395,14426442,14426395,14426426,16,34.042553,31,65.957447,51.612903,193.75,,0,16
608,14426442,14426551,14426473,14426488,94,86.238532,15,13.761468,626.666667,15.957447,,31,63
609,14426551,14426644,14426598,14426613,78,83.870968,15,16.129032,520,19.230769,,47,31
610,14426644,14426691,14426676,14426691,32,68.085106,15,31.914894,213.333333,46.875,,32,0
611,14426691,14426800,14426738,14426769,78,71.559633,31,28.440367,251.612903,39.74359,,47,31
612,14426800,14426847,14426816,14426832,31,65.957447,16,34.042553,193.75,51.612903,,16,15
613,14426847,14426941,14426894,14426910,78,82.978723,16,17.021277,487.5,20.512821,,47,31
614,14426941,14426988,14426956,14426988,15,31.914894,32,68.085106,46.875,213.333333,,15,0
615,14426988,14427097,14427034,14427066,77,70.642202,32,29.357798,240.625,41.558442,,46,31
616,14427097,14427144,14427112,14427128,31,65.957447,16,34.042553,193.75,51.612903,,15,16
617,14427144,14427237,14427175,14427206,62,66.666667,31,33.333333,200,50,,31,31
618,14427237,14427300,14427253,14427284,32,50.793651,31,49.206349,103.225806,96.875,,16,16
619,14427300,14427393,14427331,14427346,78,83.870968,15,16.129032,520,19.230769,,31,47
620,14427393,14427440,14427393,14427424,16,34.042553,31,65.957447,51.612903,193.75,,0,16
621,14427440,14427549,14427471,14427502,78,71.559633,31,28.440367,251.612903,39.74359,,31,47
622,14427549,14427643,14427596,14427612,78,82.978723,16,17.021277,487.5,20.512821,,47,31
623,14427643,14427690,14427674,14427690,31,65.957447,16,34.042553,193.75,51.612903,,31,0
624,14427690,14427799,14427736,14427768,77,70.642202,32,29.357798,240.625,41.558442,,46,31
625,14427799,14427846,14427814,14427830,31,65.957447,16,34.042553,193.75,51.612903,,15,16
626,14427846,14427939,14427892,14427908,77,82.795699,16,17.204301,481.25,20.779221,,46,31
627,14427939,14428002,14427955,14427986,32,50.793651,31,49.206349,103.225806,96.875,,16,16
628,14428002,14428095,14428033,14428048,78,83.870968,15,16.129032,520,19.230769,,31,47
629,14428095,14428142,14428111,14428126,32,68.085106,15,31.914894,213.333333,46.875,,16,16
630,14428142,14428251,14428173,14428204,78,71.559633,31,28.440367,251.612903,39.74359,,31,47
631,14428251,14428298,14428251,14428267,31,65.957447,16,34.042553,193.75,51.612903,,0,31
632,14428298,14428392,14428329,14428345,78,82.978723,16,17.021277,487.5,20.512821,,31,47
633,14428392,14428501,14428438,14428470,77,70.642202,32,29.357798,240.625,41.558442,,46,31
634,14428501,14428548,14428516,14428532,31,65.957447,16,34.042553,193.75,51.612903,,15,16
635,14428548,14428641,14428594,14428610,77,82.795699,16,17.204301,481.25,20.779221,,46,31
636,14428641,14428688,14428657,14428688,16,34.042553,31,65.957447,51.612903,193.75,,16,0
637,14428688,14428797,14428735,14428766,78,71.559633,31,28.440367,251.612903,39.74359,,47,31
638,14428797,14428844,14428813,14428828,32,68.085106,15,31.914894,213.333333,46.875,,16,16
639,14428844,14428938,14428891,14428906,79,84.042553,15,15.957447,526.666667,18.987342,,47,32
640,14428938,14429000,14428953,14428984,31,50,31,50,100,100,,15,16
641,14429000,14429094,14429031,14429062,63,67.021277,31,32.978723,203.225806,49.206349,,31,32
642,14429094,14429140,14429109,14429125,30,65.217391,16,34.782609,187.5,53.333333,,15,15
643,14429140,14429250,14429172,14429203,79,71.818182,31,28.181818,254.83871,39.240506,,32,47
644,14429250,14429296,14429250,14429265,31,67.391304,15,32.608696,206.666667,48.387097,,0,31
645,14429296,14429390,14429328,14429343,79,84.042553,15,15.957447,526.666667,18.987342,,32,47
646,14429390,14429499,14429452,14429468,93,85.321101,16,14.678899,581.25,17.204301,,62,31
647,14429499,14429546,14429515,14429546,16,34.042553,31,65.957447,51.612903,193.75,,16,0
648,14429546,14429640,14429593,14429608,79,84.042553,15,15.957447,526.666667,18.987342,,47,32
649,14429640,14429702,14429655,14429686,31,50,31,50,100,100,,15,16
650,14429702,14429796,14429733,14429764,63,67.021277,31,32.978723,203.225806,49.206349,,31,32
651,14429796,14429842,14429811,14429827,30,65.217391,16,34.782609,187.5,53.333333,,15,15
652,14429842,14429952,14429889,14429905,94,85.454545,16,14.545455,587.5,17.021277,,47,47
653,14429952,14429998,14429952,14429983,15,32.608696,31,67.391304,48.387097,206.666667,,0,15
654,14429998,14430092,14430030,14430045,79,84.042553,15,15.957447,526.666667,18.987342,,32,47
655,14430092,14430139,14430108,14430123,32,68.085106,15,31.914894,213.333333,46.875,,16,16
656,14430139,14430248,14430170,14430201,78,71.559633,31,28.440367,251.612903,39.74359,,31,47
657,14430248,14430342,14430295,14430326,63,67.021277,31,32.978723,203.225806,49.206349,,47,16
658,14430342,14430388,14430373,14430388,31,67.391304,15,32.608696,206.666667,48.387097,,31,0
659,14430388,14430498,14430435,14430466,79,71.818182,31,28.181818,254.83871,39.240506,,47,32
660,14430498,14430544,14430513,14430544,15,32.608696,31,67.391304,48.387097,206.666667,,15,0
661,14430544,14430638,14430591,14430607,78,82.978723,16,17.021277,487.5,20.512821,,47,31
662,14430638,14430700,14430654,14430685,31,50,31,50,100,100,,16,15
663,14430700,14430794,14430732,14430763,63,67.021277,31,32.978723,203.225806,49.206349,,32,31
664,14430794,14430841,14430810,14430825,32,68.085106,15,31.914894,213.333333,46.875,,16,16
665,14430841,14430950,14430888,14430903,94,86.238532,15,13.761468,626.666667,15.957447,,47,47
666,14430950,14430997,14430950,14430981,16,34.042553,31,65.957447,51.612903,193.75,,0,16
667,14430997,14431090,14431028,14431044,77,82.795699,16,17.204301,481.25,20.779221,,31,46
668,14431090,14431137,14431090,14431122,15,31.914894,32,68.085106,46.875,213.333333,,0,15
669,14431137,14431246,14431168,14431200,77,70.642202,32,29.357798,240.625,41.558442,,31,46
670,14431246,14431340,14431293,14431324,63,67.021277,31,32.978723,203.225806,49.206349,,47,16
671,14431340,14431402,14431371,14431387,46,74.193548,16,25.806452,287.5,34.782609,,31,15
672,14431402,14431496,14431434,14431465,63,67.021277,31,32.978723,203.225806,49.206349,,32,31
673,14431496,14431543,14431512,14431527,32,68.085106,15,31.914894,213.333333,46.875,,16,16
674,14431543,14431652,14431590,14431605,94,86.238532,15,13.761468,626.666667,15.957447,,47,47
675,14431652,14431699,14431652,14431683,16,34.042553,31,65.957447,51.612903,193.75,,0,16
676,14431699,14431792,14431730,14431761,62,66.666667,31,33.333333,200,50,,31,31
677,14431792,14431839,14431808,14431839,16,34.042553,31,65.957447,51.612903,193.75,,16,0
678,14431839,14431948,14431886,14431902,93,85.321101,16,14.678899,581.25,17.204301,,47,46
679,14431948,14431995,14431964,14431980,31,65.957447,16,34.042553,193.75,51.612903,,16,15
680,14431995,14432089,14432026,14432058,62,65.957447,32,34.042553,193.75,51.612903,,31,31
681,14432089,14432151,14432104,14432136,30,48.387097,32,51.612903,93.75,106.666667,,15,15
682,14432151,14432245,14432182,14432198,78,82.978723,16,17.021277,487.5,20.512821,,31,47
683,14432245,14432292,14432245,14432276,16,34.042553,31,65.957447,51.612903,193.75,,0,16
684,14432292,14432401,14432323,14432338,94,86.238532,15,13.761468,626.666667,15.957447,,31,63
685,14432401,14432494,14432448,14432463,78,83.870968,15,16.129032,520,19.230769,,47,31
686,14432494,14432588,14432526,14432541,79,84.042553,15,15.957447,526.666667,18.987342,,32,47
687,14432588,14432697,14432650,14432666,93,85.321101,16,14.678899,581.25,17.204301,,62,31
688,14432697,14432744,14432713,14432744,16,34.042553,31,65.957447,51.612903,193.75,,16,0
689,14432744,14432838,14432791,14432806,79,84.042553,15,15.957447,526.666667,18.987342,,47,32
690,14432838,14432900,14432869,14432884,47,75.806452,15,24.193548,313.333333,31.914894,,31,16
691,14432900,14432994,14432931,14432962,63,67.021277,31,32.978723,203.225806,49.206349,,31,32
692,14432994,14433040,14433009,14433040,15,32.608696,31,67.391304,48.387097,206.666667,,15,0
693,14433040,14433150,14433087,14433103,94,85.454545,16,14.545455,587.5,17.021277,,47,47
694,14433150,14433196,14433150,14433181,15,32.608696,31,67.391304,48.387097,206.666667,,0,15
695,14433196,14433290,14433228,14433259,63,67.021277,31,32.978723,203.225806,49.206349,,32,31
696,14433290,14433352,14433306,14433321,47,75.806452,15,24.193548,313.333333,31.914894,,16,31
697,14433352,14433446,14433384,14433399,79,84.042553,15,15.957447,526.666667,18.987342,,32,47
698,14433446,14433493,14433446,14433477,16,34.042553,31,65.957447,51.612903,193.75,,0,16
699,14433493,14433602,14433524,14433540,93,85.321101,16,14.678899,581.25,17.204301,,31,62
700,14433602,14433696,14433649,14433664,79,84.042553,15,15.957447,526.666667,18.987342,,47,32
701,14433696,14433742,14433711,14433742,15,32.608696,31,67.391304,48.387097,206.666667,,15,0
702,14433742,14433852,14433789,14433820,79,71.818182,31,28.181818,254.83871,39.240506,,47,32
703,14433852,14433898,14433867,14433883,30,65.217391,16,34.782609,187.5,53.333333,,15,15
704,14433898,14433992,14433945,14433961,78,82.978723,16,17.021277,487.5,20.512821,,47,31
705,14433992,14434039,14434008,14434039,16,34.042553,31,65.957447,51.612903,193.75,,16,0
706,14434039,14434148,14434086,14434101,94,86.238532,15,13.761468,626.666667,15.957447,,47,47
707,14434148,14434195,14434148,14434179,16,34.042553,31,65.957447,51.612903,193.75,,0,16
708,14434195,14434288,14434226,14434242,77,82.795699,16,17.204301,481.25,20.779221,,31,46
709,14434288,14434351,14434304,14434320,47,74.603175,16,25.396825,293.75,34.042553,,16,31
710,14434351,14434444,14434366,14434398,61,65.591398,32,34.408602,190.625,52.459016,,15,46
711,14434444,14434538,14434491,14434522,63,67.021277,31,32.978723,203.225806,49.206349,,47,16
712,14434538,14434600,14434569,14434585,46,74.193548,16,25.806452,287.5,34.782609,,31,15
713,14434600,14434694,14434647,14434663,78,82.978723,16,17.021277,487.5,20.512821,,47,31
714,14434694,14434741,14434710,14434741,16,34.042553,31,65.957447,51.612903,193.75,,16,0
715,14434741,14434850,14434788,14434803,94,86.238532,15,13.761468,626.666667,15.957447,,47,47
716,14434850,14434897,14434866,14434881,32,68.085106,15,31.914894,213.333333,46.875,,16,16
717,14434897,14434990,14434928,14434959,62,66.666667,31,33.333333,200,50,,31,31
718,14434990,14435053,14435006,14435022,47,74.603175,16,25.396825,293.75,34.042553,,16,31
719,14435053,14435146,14435084,14435100,77,82.795699,16,17.204301,481.25,20.779221,,31,46
720,14435146,14435193,14435146,14435178,15,31.914894,32,68.085106,46.875,213.333333,,0,15
721,14435193,14435302,14435224,14435256,77,70.642202,32,29.357798,240.625,41.558442,,31,46
722,14435302,14435349,14435302,14435318,31,65.957447,16,34.042553,193.75,51.612903,,0,31
723,14435349,14435443,14435365,14435396,63,67.021277,31,32.978723,203.225806,49.206349,,16,47
724,14435443,14435552,14435490,14435521,78,71.559633,31,28.440367,251.612903,39.74359,,47,31
725,14435552,14435599,14435568,14435599,16,34.042553,31,65.957447,51.612903,193.75,,16,0
726,14435599,14435692,14435646,14435661,78,83.870968,15,16.129032,520,19.230769,,47,31
727,14435692,14435739,14435708,14435739,16,34.042553,31,65.957447,51.612903,193.75,,16,0
728,14435739,14435848,14435786,14435802,93,85.321101,16,14.678899,581.25,17.204301,,47,46
729,14435848,14435895,14435864,14435880,31,65.957447,16,34.042553,193.75,51.612903,,16,15
730,14435895,14435989,14435926,14435958,62,65.957447,32,34.042553,193.75,51.612903,,31,31
731,14435989,14436051,14436004,14436036,30,48.387097,32,51.612903,93.75,106.666667,,15,15
732,14436051,14436145,14436082,14436098,78,82.978723,16,17.021277,487.5,20.512821,,31,47
733,14436145,14436192,14436145,14436176,16,34.042553,31,65.957447,51.612903,193.75,,0,16
734,14436192,14436301,14436223,14436254,78,71.559633,31,28.440367,251.612903,39.74359,,31,47
735,14436301,14436348,14436301,14436332,16,34.042553,31,65.957447,51.612903,193.75,,0,16
736,14436348,14436441,14436379,14436394,78,83.870968,15,16.129032,520,19.230769,,31,47
737,14436441,14436488,14436441,14436472,16,34.042553,31,65.957447,51.612903,193.75,,0,16
738,14436488,14436597,14436519,14436550,78,71.559633,31,28.440367,251.612903,39.74359,,31,47
739,14436597,14436691,14436644,14436675,63,67.021277,31,32.978723,203.225806,49.206349,,47,16
740,14436691,14436738,14436722,14436738,31,65.957447,16,34.042553,193.75,51.612903,,31,0
741,14436738,14436847,14436784,14436816,77,70.642202,32,29.357798,240.625,41.558442,,46,31
742,14436847,14436894,14436862,14436894,15,31.914894,32,68.085106,46.875,213.333333,,15,0
743,14436894,14437003,14436940,14436956,93,85.321101,16,14.678899,581.25,17.204301,,46,47
744,14437003,14437050,14437003,14437034,16,34.042553,31,65.957447,51.612903,193.75,,0,16
745,14437050,14437143,14437081,14437112,62,66.666667,31,33.333333,200,50,,31,31
746,14437143,14437190,14437159,14437174,32,68.085106,15,31.914894,213.333333,46.875,,16,16
747,14437190,14437299,14437237,14437252,94,86.238532,15,13.761468,626.666667,15.957447,,47,47
748,14437299,14437346,14437299,14437330,16,34.042553,31,65.957447,51.612903,193.75,,0,16
749,14437346,14437440,14437377,14437393,78,82.978723,16,17.021277,487.5,20.512821,,31,47
750,14437440,14437502,14437455,14437471,46,74.193548,16,25.806452,287.5,34.782609,,15,31
751,14437502,14437596,14437518,14437549,63,67.021277,31,32.978723,203.225806,49.206349,,16,47
752,14437596,14437689,14437642,14437674,61,65.591398,32,34.408602,190.625,52.459016,,46,15
753,14437689,14437752,14437720,14437736,47,74.603175,16,25.396825,293.75,34.042553,,31,16
754,14437752,14437845,14437798,14437814,77,82.795699,16,17.204301,481.25,20.779221,,46,31
755,14437845,14437892,14437861,14437892,16,34.042553,31,65.957447,51.612903,193.75,,16,0
756,14437892,14438001,14437939,14437954,94,86.238532,15,13.761468,626.666667,15.957447,,47,47
757,14438001,14438048,14438017,14438032,32,68.085106,15,31.914894,213.333333,46.875,,16,16
758,14438048,14438142,14438079,14438110,63,67.021277,31,32.978723,203.225806,49.206349,,31,32
759,14438142,14438188,14438157,14438173,30,65.217391,16,34.782609,187.5,53.333333,,15,15
760,14438188,14438298,14438235,14438251,94,85.454545,16,14.545455,587.5,17.021277,,47,47
761,14438298,14438344,14438298,14438329,15,32.608696,31,67.391304,48.387097,206.666667,,0,15
762,14438344,14438438,14438376,14438391,79,84.042553,15,15.957447,526.666667,18.987342,,32,47
763,14438438,14438500,14438454,14438469,47,75.806452,15,24.193548,313.333333,31.914894,,16,31
764,14438500,14438594,14438516,14438547,63,67.021277,31,32.978723,203.225806,49.206349,,16,47
765,14438594,14438688,14438641,14438672,63,67.021277,31,32.978723,203.225806,49.206349,,47,16
766,14438688,14438750,14438719,14438734,47,75.806452,15,24.193548,313.333333,31.914894,,31,16
767,14438750,14438844,14438797,14438812,79,84.042553,15,15.957447,526.666667,18.987342,,47,32
768,14438844,14438890,14438859,14438890,15,32.608696,31,67.391304,48.387097,206.666667,,15,0
769,14438890,14439000,14438937,14438968,79,71.818182,31,28.181818,254.83871,39.240506,,47,32
770,14439000,14439046,14439015,14439031,30,65.217391,16,34.782609,187.5,53.333333,,15,15
771,14439046,14439140,14439093,14439109,78,82.978723,16,17.021277,487.5,20.512821,,47,31
772,14439140,14439202,14439156,14439187,31,50,31,50,100,100,,16,15
773,14439202,14439296,14439234,14439265,63,67.021277,31,32.978723,203.225806,49.206349,,32,31
774,14439296,14439343,14439312,14439327,32,68.085106,15,31.914894,213.333333,46.875,,16,16
775,14439343,14439452,14439390,14439405,94,86.238532,15,13.761468,626.666667,15.957447,,47,47
776,14439452,14439499,14439452,14439483,16,34.042553,31,65.957447,51.612903,193.75,,0,16
777,14439499,14439592,14439530,14439561,62,66.666667,31,33.333333,200,50,,31,31
778,14439592,14439639,14439608,14439624,31,65.957447,16,34.042553,193.75,51.612903,,16,15
779,14439639,14439748,14439670,14439702,77,70.642202,32,29.357798,240.625,41.558442,,31,46
780,14439748,14439795,14439748,14439780,15,31.914894,32,68.085106,46.875,213.333333,,0,15
781,14439795,14439889,14439826,14439842,78,82.978723,16,17.021277,487.5,20.512821,,31,47
782,14439889,14439998,14439951,14439967,93,85.321101,16,14.678899,581.25,17.204301,,62,31
783,14439998,14440045,14440014,14440045,16,34.042553,31,65.957447,51.612903,193.75,,16,0
784,14440045,14440138,14440092,14440107,78,83.870968,15,16.129032,520,19.230769,,47,31
785,14440138,14440201,14440170,14440185,48,76.190476,15,23.809524,320,31.25,,32,16
786,14440201,14440294,14440232,14440263,62,66.666667,31,33.333333,200,50,,31,31
787,14440294,14440341,14440310,14440341,16,34.042553,31,65.957447,51.612903,193.75,,16,0
788,14440341,14440450,14440388,14440404,93,85.321101,16,14.678899,581.25,17.204301,,47,46
789,14440450,14440497,14440466,14440482,31,65.957447,16,34.042553,193.75,51.612903,,16,15
790,14440497,14440591,14440528,14440560,62,65.957447,32,34.042553,193.75,51.612903,,31,31
791,14440591,14440638,14440606,14440622,31,65.957447,16,34.042553,193.75,51.612903,,15,16
792,14440638,14440747,14440684,14440700,93,85.321101,16,14.678899,581.25,17.204301,,46,47
793,14440747,14440794,14440747,14440778,16,34.042553,31,65.957447,51.612903,193.75,,0,16
794,14440794,14440903,14440825,14440840,94,86.238532,15,13.761468,626.666667,15.957447,,31,63
795,14440903,14440950,14440903,14440918,32,68.085106,15,31.914894,213.333333,46.875,,0,32
796,14440950,14440996,14440965,14440996,15,32.608696,31,67.391304,48.387097,206.666667,,15,0
797,14440996,14441090,14441043,14441059,78,82.978723,16,17.021277,487.5,20.512821,,47,31
798,14441090,14441152,14441121,14441137,46,74.193548,16,25.806452,287.5,34.782609,,31,15
799,14441152,14441246,14441184,14441215,63,67.021277,31,32.978723,203.225806,49.206349,,32,31
800,14441246,14441293,14441262,14441277,32,68.085106,15,31.914894,213.333333,46.875,,16,16
801,14441293,14441402,14441324,14441355,78,71.559633,31,28.440367,251.612903,39.74359,,31,47
802,14441402,14441449,14441402,14441433,16,34.042553,31,65.957447,51.612903,193.75,,0,16
803,14441449,14441542,14441480,14441496,77,82.795699,16,17.204301,481.25,20.779221,,31,46
804,14441542,14441589,14441542,14441574,15,31.914894,32,68.085106,46.875,213.333333,,0,15
805,14441589,14441698,14441620,14441652,77,70.642202,32,29.357798,240.625,41.558442,,31,46
806,14441698,14441792,14441745,14441776,63,67.021277,31,32.978723,203.225806,49.206349,,47,16
807,14441792,14441839,14441823,14441839,31,65.957447,16,34.042553,193.75,51.612903,,31,0
808,14441839,14441948,14441901,14441917,93,85.321101,16,14.678899,581.25,17.204301,,62,31
809,14441948,14441995,14441964,14441995,16,34.042553,31,65.957447,51.612903,193.75,,16,0
810,14441995,14442088,14442042,14442057,78,83.870968,15,16.129032,520,19.230769,,47,31
811,14442088,14442151,14442104,14442135,32,50.793651,31,49.206349,103.225806,96.875,,16,16
812,14442151,14442244,14442182,14442213,62,66.666667,31,33.333333,200,50,,31,31
813,14442244,14442291,14442260,14442276,31,65.957447,16,34.042553,193.75,51.612903,,16,15
814,14442291,14442400,14442338,14442354,93,85.321101,16,14.678899,581.25,17.204301,,47,46
815,14442400,14442447,14442400,14442416,31,65.957447,16,34.042553,193.75,51.612903,,0,31
816,14442447,14442541,14442478,14442494,78,82.978723,16,17.021277,487.5,20.512821,,31,47
817,14442541,14442603,14442556,14442572,46,74.193548,16,25.806452,287.5,34.782609,,15,31
818,14442603,14442697,14442619,14442650,63,67.021277,31,32.978723,203.225806,49.206349,,16,47
819,14442697,14442790,14442744,14442775,62,66.666667,31,33.333333,200,50,,47,15
820,14442790,14442853,14442822,14442837,48,76.190476,15,23.809524,320,31.25,,32,16
821,14442853,14442946,14442900,14442915,78,83.870968,15,16.129032,520,19.230769,,47,31
822,14442946,14442993,14442962,14442993,16,34.042553,31,65.957447,51.612903,193.75,,16,0
823,14442993,14443102,14443040,14443071,78,71.559633,31,28.440367,251.612903,39.74359,,47,31
824,14443102,14443149,14443118,14443134,31,65.957447,16,34.042553,193.75,51.612903,,16,15
825,14443149,14443243,14443180,14443212,62,65.957447,32,34.042553,193.75,51.612903,,31,31
826,14443243,14443290,14443258,14443290,15,31.914894,32,68.085106,46.875,213.333333,,15,0
827,14443290,14443399,14443336,14443352,93,85.321101,16,14.678899,581.25,17.204301,,46,47
828,14443399,14443446,14443414,14443430,31,65.957447,16,34.042553,193.75,51.612903,,15,16
829,14443446,14443539,14443477,14443508,62,66.666667,31,33.333333,200,50,,31,31
830,14443539,14443602,14443555,14443586,32,50.793651,31,49.206349,103.225806,96.875,,16,16
831,14443602,14443695,14443633,14443648,78,83.870968,15,16.129032,520,19.230769,,31,47
832,14443695,14443742,14443695,14443726,16,34.042553,31,65.957447,51.612903,193.75,,0,16
833,14443742,14443851,14443773,14443789,93,85.321101,16,14.678899,581.25,17.204301,,31,62
834,14443851,14443945,14443898,14443914,78,82.978723,16,17.021277,487.5,20.512821,,47,31
835,14443945,14443992,14443976,14443992,31,65.957447,16,34.042553,193.75,51.612903,,31,0
836,14443992,14444101,14444038,14444070,77,70.642202,32,29.357798,240.625,41.558442,,46,31
837,14444101,14444148,14444116,14444132,31,65.957447,16,34.042553,193.75,51.612903,,15,16
838,14444148,14444241,14444194,14444210,77,82.795699,16,17.204301,481.25,20.779221,,46,31
839,14444241,14444288,14444257,14444288,16,34.042553,31,65.957447,51.612903,193.75,,16,0
840,14444288,14444397,14444335,14444366,78,71.559633,31,28.440367,251.612903,39.74359,,47,31
841,14444397,14444444,14444413,14444428,32,68.085106,15,31.914894,213.333333,46.875,,16,16
842,14444444,14444553,14444475,14444506,78,71.559633,31,28.440367,251.612903,39.74359,,31,47
843,14444553,14444600,14444553,14444584,16,34.042553,31,65.957447,51.612903,193.75,,0,16
844,14444600,14444694,14444631,14444647,78,82.978723,16,17.021277,487.5,20.512821,,31,47
845,14444694,14444740,14444709,14444725,30,65.217391,16,34.782609,187.5,53.333333,,15,15
846,14444740,14444850,14444772,14444803,79,71.818182,31,28.181818,254.83871,39.240506,,32,47
847,14444850,14444943,14444896,14444928,61,65.591398,32,34.408602,190.625,52.459016,,46,15
848,14444943,14445052,14444974,14444990,93,85.321101,16,14.678899,581.25,17.204301,,31,62
849,14445052,14445146,14445099,14445115,78,82.978723,16,17.021277,487.5,20.512821,,47,31
850,14445146,14445193,14445162,14445193,16,34.042553,31,65.957447,51.612903,193.75,,16,0
851,14445193,14445302,14445240,14445271,78,71.559633,31,28.440367,251.612903,39.74359,,47,31
852,14445302,14445349,14445318,14445333,32,68.085106,15,31.914894,213.333333,46.875,,16,16
853,14445349,14445442,14445396,14445411,78,83.870968,15,16.129032,520,19.230769,,47,31
854,14445442,14445489,14445458,14445489,16,34.042553,31,65.957447,51.612903,193.75,,16,0
855,14445489,14445598,14445536,14445567,78,71.559633,31,28.440367,251.612903,39.74359,,47,31
856,14445598,14445645,14445614,14445630,31,65.957447,16,34.042553,193.75,51.612903,,16,15
857,14445645,14445739,14445692,14445708,78,82.978723,16,17.021277,487.5,20.512821,,47,31
858,14445739,14445801,14445754,14445786,30,48.387097,32,51.612903,93.75,106.666667,,15,15
859,14445801,14445895,14445832,14445864,62,65.957447,32,34.042553,193.75,51.612903,,31,31
860,14445895,14445942,14445910,14445926,31,65.957447,16,34.042553,193.75,51.612903,,15,16
861,14445942,14446051,14445988,14446004,93,85.321101,16,14.678899,581.25,17.204301,,46,47
862,14446051,14446098,14446051,14446082,16,34.042553,31,65.957447,51.612903,193.75,,0,16
863,14446098,14446191,14446129,14446144,78,83.870968,15,16.129032,520,19.230769,,31,47
864,14446191,14446238,14446207,14446222,32,68.085106,15,31.914894,213.333333,46.875,,16,16
865,14446238,14446347,14446269,14446300,78,71.559633,31,28.440367,251.612903,39.74359,,31,47
866,14446347,14446441,14446394,14446425,63,67.021277,31,32.978723,203.225806,49.206349,,47,16
867,14446441,14446503,14446472,14446488,46,74.193548,16,25.806452,287.5,34.782609,,31,15
868,14446503,14446597,14446534,14446566,62,65.957447,32,34.042553,193.75,51.612903,,31,31
869,14446597,14446644,14446612,14446644,15,31.914894,32,68.085106,46.875,213.333333,,15,0
870,14446644,14446753,14446690,14446706,93,85.321101,16,14.678899,581.25,17.204301,,46,47
871,14446753,14446800,14446753,14446784,16,34.042553,31,65.957447,51.612903,193.75,,0,16
872,14446800,14446893,14446831,14446862,62,66.666667,31,33.333333,200,50,,31,31
873,14446893,14446940,14446909,14446924,32,68.085106,15,31.914894,213.333333,46.875,,16,16
874,14446940,14447049,14446971,14447002,78,71.559633,31,28.440367,251.612903,39.74359,,31,47
875,14447049,14447096,14447065,14447080,32,68.085106,15,31.914894,213.333333,46.875,,16,16
876,14447096,14447190,14447127,14447158,63,67.021277,31,32.978723,203.225806,49.206349,,31,32
877,14447190,14447252,14447205,14447221,46,74.193548,16,25.806452,287.5,34.782609,,15,31
878,14447252,14447346,14447283,14447299,78,82.978723,16,17.021277,487.5,20.512821,,31,47
879,14447346,14447392,14447346,14447377,15,32.608696,31,67.391304,48.387097,206.666667,,0,15
880,14447392,14447439,14447424,14447439,32,68.085106,15,31.914894,213.333333,46.875,,32,0
881,14447439,14447548,14447486,14447517,78,71.559633,31,28.440367,251.612903,39.74359,,47,31
882,14447548,14447595,14447564,14447580,31,65.957447,16,34.042553,193.75,51.612903,,16,15
883,14447595,14447689,14447642,14447658,78,82.978723,16,17.021277,487.5,20.512821,,47,31
884,14447689,14447751,14447704,14447736,30,48.387097,32,51.612903,93.75,106.666667,,15,15
885,14447751,14447845,14447782,14447814,62,65.957447,32,34.042553,193.75,51.612903,,31,31
886,14447845,14447892,14447860,14447876,31,65.957447,16,34.042553,193.75,51.612903,,15,16
887,14447892,14448001,14447923,14447954,78,71.559633,31,28.440367,251.612903,39.74359,,31,47
888,14448001,14448048,14448001,14448016,32,68.085106,15,31.914894,213.333333,46.875,,0,32
889,14448048,14448141,14448079,14448094,78,83.870968,15,16.129032,520,19.230769,,31,47
890,14448141,14448188,14448141,14448172,16,34.042553,31,65.957447,51.612903,193.75,,0,16
891,14448188,14448297,14448219,14448250,78,71.559633,31,28.440367,251.612903,39.74359,,31,47
892,14448297,14448391,14448344,14448375,63,67.021277,31,32.978723,203.225806,49.206349,,47,16
893,14448391,14448453,14448422,14448438,46,74.193548,16,25.806452,287.5,34.782609,,31,15
894,14448453,14448547,14448485,14448516,63,67.021277,31,32.978723,203.225806,49.206349,,32,31
895,14448547,14448594,14448563,14448578,32,68.085106,15,31.914894,213.333333,46.875,,16,16
896,14448594,14448703,14448641,14448656,94,86.238532,15,13.761468,626.666667,15.957447,,47,47
897,14448703,14448750,14448703,14448734,16,34.042553,31,65.957447,51.612903,193.75,,0,16
898,14448750,14448843,14448781,14448797,77,82.795699,16,17.204301,481.25,20.779221,,31,46
899,14448843,14448890,14448859,14448875,31,65.957447,16,34.042553,193.75,51.612903,,16,15
900,14448890,14448999,14448921,14448953,77,70.642202,32,29.357798,240.625,41.558442,,31,46
901,14448999,14449046,14448999,14449031,15,31.914894,32,68.085106,46.875,213.333333,,0,15
902,14449046,14449140,14449077,14449093,78,82.978723,16,17.021277,487.5,20.512821,,31,47
903,14449140,14449249,14449202,14449218,93,85.321101,16,14.678899,581.25,17.204301,,62,31
904,14449249,14449296,14449265,14449296,16,34.042553,31,65.957447,51.612903,193.75,,16,0
905,14449296,14449389,14449343,14449358,78,83.870968,15,16.129032,520,19.230769,,47,31
906,14449389,14449452,14449421,14449436,48,76.190476,15,23.809524,320,31.25,,32,16
907,14449452,14449545,14449483,14449514,62,66.666667,31,33.333333,200,50,,31,31
908,14449545,14449592,14449561,14449577,31,65.957447,16,34.042553,193.75,51.612903,,16,15
909,14449592,14449701,14449639,14449655,93,85.321101,16,14.678899,581.25,17.204301,,47,46
910,14449701,14449748,14449701,14449733,15,31.914894,32,68.085106,46.875,213.333333,,0,15
911,14449748,14449842,14449779,14449811,62,65.957447,32,34.042553,193.75,51.612903,,31,31
912,14449842,14449889,14449857,14449873,31,65.957447,16,34.042553,193.75,51.612903,,15,16
913,14449889,14449998,14449920,14449951,78,71.559633,31,28.440367,251.612903,39.74359,,31,47
914,14449998,14450045,14449998,14450013,32,68.085106,15,31.914894,213.333333,46.875,,0,32
915,14450045,14450091,14450076,14450091,31,67.391304,15,32.608696,206.666667,48.387097,,31,0
916,14450091,14450201,14450138,14450169,79,71.818182,31,28.181818,254.83871,39.240506,,47,32
917,14450201,14450247,14450216,14450232,30,65.217391,16,34.782609,187.5,53.333333,,15,15
918,14450247,14450341,14450294,14450310,78,82.978723,16,17.021277,487.5,20.512821,,47,31
919,14450341,14450403,14450357,14450388,31,50,31,50,100,100,,16,15
920,14450403,14450497,14450435,14450466,63,67.021277,31,32.978723,203.225806,49.206349,,32,31
921,14450497,14450544,14450513,14450528,32,68.085106,15,31.914894,213.333333,46.875,,16,16
922,14450544,14450653,14450591,14450606,94,86.238532,15,13.761468,626.666667,15.957447,,47,47
923,14450653,14450700,14450653,14450684,16,34.042553,31,65.957447,51.612903,193.75,,0,16
924,14450700,14450793,14450731,14450747,77,82.795699,16,17.204301,481.25,20.779221,,31,46
925,14450793,14450840,14450809,14450825,31,65.957447,16,34.042553,193.75,51.612903,,16,15
926,14450840,14450949,14450871,14450903,77,70.642202,32,29.357798,240.625,41.558442,,31,46
927,14450949,14450996,14450949,14450981,15,31.914894,32,68.085106,46.875,213.333333,,0,15
928,14450996,14451090,14451027,14451043,78,82.978723,16,17.021277,487.5,20.512821,,31,47
929,14451090,14451152,14451105,14451121,46,74.193548,16,25.806452,287.5,34.782609,,15,31
930,14451152,14451199,14451168,14451199,16,34.042553,31,65.957447,51.612903,193.75,,16,0
931,14451199,14451293,14451246,14451261,79,84.042553,15,15.957447,526.666667,18.987342,,47,32
932,14451293,14451339,14451324,14451339,31,67.391304,15,32.608696,206.666667,48.387097,,31,0
933,14451339,14451449,14451386,14451417,79,71.818182,31,28.181818,254.83871,39.240506,,47,32
934,14451449,14451495,14451464,14451480,30,65.217391,16,34.782609,187.5,53.333333,,15,15
935,14451495,14451589,14451542,14451558,78,82.978723,16,17.021277,487.5,20.512821,,47,31
936,14451589,14451651,14451605,14451636,31,50,31,50,100,100,,16,15
937,14451651,14451745,14451683,14451714,63,67.021277,31,32.978723,203.225806,49.206349,,32,31
938,14451745,14451792,14451761,14451776,32,68.085106,15,31.914894,213.333333,46.875,,16,16
939,14451792,14451901,14451839,14451854,94,86.238532,15,13.761468,626.666667,15.957447,,47,47
940,14451901,14451948,14451901,14451932,16,34.042553,31,65.957447,51.612903,193.75,,0,16
941,14451948,14452041,14451979,14451995,77,82.795699,16,17.204301,481.25,20.779221,,31,46
942,14452041,14452104,14452057,14452073,47,74.603175,16,25.396825,293.75,34.042553,,16,31
943,14452104,14452197,14452119,14452151,61,65.591398,32,34.408602,190.625,52.459016,,15,46
944,14452197,14452244,14452197,14452229,15,31.914894,32,68.085106,46.875,213.333333,,0,15
945,14452244,14452291,14452275,14452291,31,65.957447,16,34.042553,193.75,51.612903,,31,0
946,14452291,14452400,14452338,14452369,78,71.559633,31,28.440367,251.612903,39.74359,,47,31
947,14452400,14452447,14452416,14452447,16,34.042553,31,65.957447,51.612903,193.75,,16,0
948,14452447,14452541,14452494,14452509,79,84.042553,15,15.957447,526.666667,18.987342,,47,32
949,14452541,14452603,14452572,14452587,47,75.806452,15,24.193548,313.333333,31.914894,,31,16
950,14452603,14452697,14452634,14452665,63,67.021277,31,32.978723,203.225806,49.206349,,31,32
951,14452697,14452743,14452712,14452728,30,65.217391,16,34.782609,187.5,53.333333,,15,15
952,14452743,14452853,14452790,14452806,94,85.454545,16,14.545455,587.5,17.021277,,47,47
953,14452853,14452899,14452853,14452884,15,32.608696,31,67.391304,48.387097,206.666667,,0,15
954,14452899,14452993,14452931,14452946,79,84.042553,15,15.957447,526.666667,18.987342,,32,47
955,14452993,14453040,14453009,14453024,32,68.085106,15,31.914894,213.333333,46.875,,16,16
956,14453040,14453149,14453071,14453102,78,71.559633,31,28.440367,251.612903,39.74359,,31,47
957,14453149,14453243,14453196,14453227,63,67.021277,31,32.978723,203.225806,49.206349,,47,16
958,14453243,14453289,14453274,14453289,31,67.391304,15,32.608696,206.666667,48.387097,,31,0
959,14453289,14453399,14453336,14453367,79,71.818182,31,28.181818,254.83871,39.240506,,47,32
960,14453399,14453445,14453414,14453430,30,65.217391,16,34.782609,187.5,53.333333,,15,15
961,14453445,14453539,14453492,14453508,78,82.978723,16,17.021277,487.5,20.512821,,47,31
962,14453539,14453601,14453555,14453586,31,50,31,50,100,100,,16,15
963,14453601,14453695,14453633,14453648,79,84.042553,15,15.957447,526.666667,18.987342,,32,47
964,14453695,14453742,14453711,14453726,32,68.085106,15,31.914894,213.333333,46.875,,16,16
965,14453742,14453851,14453773,14453804,78,71.559633,31,28.440367,251.612903,39.74359,,31,47
966,14453851,14453898,14453851,14453867,31,65.957447,16,34.042553,193.75,51.612903,,0,31
967,14453898,14453991,14453929,14453945,77,82.795699,16,17.204301,481.25,20.779221,,31,46
968,14453991,14454101,14454054,14454069,95,86.363636,15,13.636364,633.333333,15.789474,,63,32
969,14454101,14454194,14454132,14454147,78,83.870968,15,16.129032,520,19.230769,,31,47
970,14454194,14454241,14454194,14454225,16,34.042553,31,65.957447,51.612903,193.75,,0,16
971,14454241,14454303,14454272,14454288,46,74.193548,16,25.806452,287.5,34.782609,,31,15
972,14454303,14454397,14454350,14454366,78,82.978723,16,17.021277,487.5,20.512821,,47,31
973,14454397,14454444,14454413,14454444,16,34.042553,31,65.957447,51.612903,193.75,,16,0
974,14454444,14454553,14454491,14454522,78,71.559633,31,28.440367,251.612903,39.74359,,47,31
975,14454553,14454600,14454569,14454584,32,68.085106,15,31.914894,213.333333,46.875,,16,16
976,14454600,14454693,14454631,14454662,62,66.666667,31,33.333333,200,50,,31,31
977,14454693,14454740,14454709,14454740,16,34.042553,31,65.957447,51.612903,193.75,,16,0
978,14454740,14454849,14454787,14454803,93,85.321101,16,14.678899,581.25,17.204301,,47,46
979,14454849,14454896,14454865,14454881,31,65.957447,16,34.042553,193.75,51.612903,,16,15
980,14454896,14454990,14454927,14454959,62,65.957447,32,34.042553,193.75,51.612903,,31,31
981,14454990,14455052,14455005,14455021,46,74.193548,16,25.806452,287.5,34.782609,,15,31
982,14455052,14455146,14455068,14455099,63,67.021277,31,32.978723,203.225806,49.206349,,16,47
983,14455146,14455193,14455146,14455177,16,34.042553,31,65.957447,51.612903,193.75,,0,16
984,14455193,14455239,14455224,14455239,31,67.391304,15,32.608696,206.666667,48.387097,,31,0
985,14455239,14455349,14455302,14455317,95,86.363636,15,13.636364,633.333333,15.789474,,63,32
986,14455349,14455395,14455364,14455395,15,32.608696,31,67.391304,48.387097,206.666667,,15,0
987,14455395,14455489,14455442,14455458,78,82.978723,16,17.021277,487.5,20.512821,,47,31
988,14455489,14455551,14455505,14455536,31,50,31,50,100,100,,16,15
989,14455551,14455645,14455583,14455614,63,67.021277,31,32.978723,203.225806,49.206349,,32,31
990,14455645,14455692,14455661,14455676,32,68.085106,15,31.914894,213.333333,46.875,,16,16
991,14455692,14455801,14455723,14455754,78,71.559633,31,28.440367,251.612903,39.74359,,31,47
992,14455801,14455848,14455801,14455832,16,34.042553,31,65.957447,51.612903,193.75,,0,16
993,14455848,14455941,14455879,14455895,77,82.795699,16,17.204301,481.25,20.779221,,31,46
994,14455941,14456004,14455957,14455973,47,74.603175,16,25.396825,293.75,34.042553,,16,31
995,14456004,14456097,14456019,14456051,61,65.591398,32,34.408602,190.625,52.459016,,15,46
996,14456097,14456191,14456144,14456175,63,67.021277,31,32.978723,203.225806,49.206349,,47,16
997,14456191,14456253,14456222,14456238,46,74.193548,16,25.806452,287.5,34.782609,,31,15
998,14456253,14456347,14456285,14456316,63,67.021277,31,32.978723,203.225806,49.206349,,32,31
999,14456347,14456394,14456363,14456394,16,34.042553,31,65.957447,51.612903,193.75,,16,0
